Author	POB
	
Willem Maas	Utrecht
Joep Nicolas	
Willem Nieuwenhuis	
Karel van den Oever	Antwerpen
Wies Moens	Sint-Gillis-Bij-Dendermonde
Eduard A. Serrarens	Maastricht
L.J.M. Feber	Bergen op Zoom
G.P.M. Knuvelder	Arnhem
Jan Bruna	
Bernard Verhoeven	Arnhem
Adr. E. Maas	Rotterdam
M. Bruna	Utrecht
Ed. Hoornik	Den Haag
Gerard Bruning	Amsterdam
Sybold van Ravesteyn	
Jos. van der Kolk	
C.A. Terburg	
J.A. Dom Gregorius de Wit	Hilversum
Jean Cocteau	Maisons-Laffitte
Wim Snitker	
Eliseus Bruning	Geldrop
Willem ten Berge	Leens
Wouter Lutkie	Hertogenbosch
Hendrik Andriessen	Haarlem
Henriette Roland Holst-van der Schalk	Noordwijk
Kees Meekel	Amstelveen
Pieter van der Meer de Walcheren	Utrecht
Herman de Man	Woerden
Michel de Ghelderode	Elsene
Willem Putman	Waregem
To Hölscher	Helmond
Jan Campert	Spijkenisse
Jos. Panhuijsen	Tilburg
Pierre Kemp	Maastricht
Paul van Ostaijen	Antwerpen
Victor J. Brunclair	Antwerpen
Marie Koenen	's-Hertogenbosch
A. Roland Holst	Amsterdam
Roel Houwink	Breda
Mathias Kemp	Maastricht
J.C. van Schagen	Vlissingen
Henrik Scholte	Groningen
A. den Doolaard	Zwolle
Martien Beversluis	Barendrecht
J.J. ten Berge S.J.	Leens
Erich Wichman	Utrecht
Blaise Cendrars	La Chaux-de-Fonds
H.W.E. Moller	Amsterdam
Dop Bles	Rotterdam
Hans van Zijl	
François Villon	Frankrijk
J. Wille	Koudekerk a/d Rijn
Henri Morel	Nijmegen
J.H. Horemans	
Theo Vonck	
Lambert Melissen	Langeweg
Gerard Wijdeveld	
[tijdschrift] Dietsche Warande en Belfort	
Mien Proost	Amsterdam
Jacques Gans	Hilversum
Theo Schlichting	Graft
H.E.H. van Loon	Rotterdam
J.F.M. Sterck	Amsterdam
J.C. Bloem	Oudshoorn
Vic Reinders	Maastricht
Jan H. Eekhout	Sluis
Huub van der Grinten	
F.J.H. Lousberg	Maastricht
Henri Borel	Dordrecht
D.A.M. Binnendijk	Leiden
Jacques Schreurs	Sittard
J.J. van Geuns	Zierikzee
Halbo C. Kool	Groningen
Emile Erens	Schaesberg
Maurits Mok	Haarlem
Gabriël Smit	Utrecht
Joris Ivens	Nijmegen
Luc Tournier	Rotterdam
Wilhelmus Nicolaï	Amsterdam
A.J.A. Etman	Den Haag
J.B. Stolte	
N.G.H. Deen	Den Haag
Frans Erens	Schaesberg
Charles Eyck	Meerssen
Ad. Sassen	
Lodewijk van Deyssel	Amsterdam
Jan Thorn-Prikker	Den Haag
Alfons Olterdissen	Maastricht?
G.D. Franquinet	Maastricht
E. Jaspar	Maastricht
Laurent Polis	Maastricht
G.H. Weustink	
P. Hendrix	Halsteren
M. Revis	Zeist
Jan H. de Groot	Alkmaar
Frans van Oldenburg Ermke	Dordrecht
A. van Domburg	Oud Gastel
Giovanni Papini	
Martin Bruijns	Wisch
Eric van der Steen	Alkmaar
Leo van Breen	Goes
Herman Oosterwijk	
Louis de Bourbon	Renkum
Berend Kuitert Cz	
Alphons Diepenbrock	Amsterdam
Aug. Cuypers	Amsterdam
Stijn Streuvels	Heule
Paul Vlemminx	Schijndel
Franciscus De Smidt	Antwerpen
G.J. Peelen	
Heleen Hoekstra	
A.P.Th. Sassen	Roermond
Jos. van Schaveren	
E.Th.J. Brom	Amsterdam
G. Vrijmoed	Rotterdam
Koos van Doorne	
Willem Brandt	Groningen
E.H.M. Beekman	Den Haag
H. van Rooijen	Utrecht
C.R. de Klerk	Woubrugge
H.M. van Randwijk	Gorinchem
Antoon Coolen	Wijlre
J.H. Newman	Londen
Hendrik de Vries	Groningen
Gaston Burssens	Dendermonde
Paul Claudel	Villeneuve-sur-Fère
Michiel de Swaen	Duinkerken
Wouter Paap	Utrecht
David de Kok	Rotterdam
J.A.A. Mekel	Bedum
Felix Rutten	Sittard
Freek van Leeuwen	Leiden
Kees Klap	
C.C. Berg	Rotterdam
Jan Gin	Goes
Johan Brouwer	Rotterdam
Charles Nypels	Maastricht
Marie Gijsen	Gouda
Luc van Hoek	
Willem Nolet	Schiedam
A.G.W. Severijnen	
G.W. van der Does	Arnhem
C.P.M. Romme	Oirschot
J.W.F. Werumeus Buning	Velp
Hubert Cuypers jr.	
Jac. van Hattum	Wommels
Renaat de Vos	
F.Ph.A. Tellegen	
Ernest van der Hallen	Lier
Leo Boekraad	Boskoop
Herman Hutte	
Esther Hadassa Weyl	
Piet Oomes	Hengelo
Ben van Eysselsteijn	Hellevoetsluis
L.S.J. Hanekroot	
Joannes Reddingius	Deurne
Bertus Aafjes	Amsterdam
Paul Haimon	Ohe en Laak
K. Steur	Volendam
Gerth Schreiner	Laubach
Jo Manders	Amsterdam
J. Slauerhoff	Leeuwarden
A.J.M. Cornelissen	
Gerard den Brabander	Den Haag
Carole Vos	
Bert Bakker	Huizem
Frank Valkenier	Tilburg
P.J.H. Vermeeren	Maastricht
Simon Vestdijk	Harlingen
Bert Decorte	Retie
Martin Leopold	
Johan de Molenaar	Amsterdam
Piet Beek	
Willem Hoffman	
Wiel van der Randen	Venlo
C.J. Vos	Utrecht
G. Engelberg	Antwerpen
René Berghen	Antwerpen
Marcel Matthijs	Oedelem (Beernem)
Maurice Gilliams	Antwerpen
Bert Verbist	
Blanka Gyselen	Antwerpen
Marnix van Gavere	Deinze
René Verbeeck	Wilsele
Edgar Twello	
A. van der Wey	
Charles Roelofsz	Amsterdam
August Vermeylen	Brussel
Adrien Jans	Edegem
Hans Keilson	Bad Freienwalde
Jan Bent	
Maurits Dekker	Amsterdam
Gustav Delory	Lille
Jacob Hendrik van Duinen	Groningen
Joh. Hartog	
Chris van der Weye	Amsterdam
F.J.J. Buytendijk	
Roel Verlaan	
Leo Heirman	Lisse
Albert C.A. Voortman	
Max de Jong	Wageningen
A.G.M. van de Wijnpersse	
Robert Franquinet	Amby
Maarten Vrolijk	Scheveningen
Bert Peleman	Puurs
A. Marja	Oude Leije
Reinold Kuipers	Groningen
Ferd. Sassen	Nijmegen
D.A. de Graaf	Utrecht
Walter Breedveld	Hertogenbosch
Marianne Philips	Amsterdam
Jeanne Liedmeier	
G. Vos de Wael	
Loe Maas	Maastricht
K.J. Hahn	
Jacques Benoit	Leiden
Hendrik Houwens Post	Soerakarta
Hélène Nolthenius	Amsterdam
Johan Berger	Aalst
A.L.M. Arnolds	Bergen op Zoom
Victor E. van Vriesland	Haarlem
C.J. Kelk	Amsterdam
H.W.J.M. Keuls	Obdam
H.J.M.F. Lodewick	Maastricht
Ab Visser	Groningen
Hubert Janssen	Rotterdam
Jacques Idserda	Loosdrecht
Jan Derks	
J. van Delden	Beerta
F.J.J. Buitendijk	
P.H. van der Kemp	
Otto Dijk	Vlijmen
Otto van Eck	
Max Prick van Wely	
Anton van der Vet	
Peter Crassaerts	
R.J. Valkhoff	
J.J. Nieuwburg	
H. de Vries	
W.J.C. van Hasselt	Amsterdam
Nicolaas Beets	Haarlem
Jan Pieter Heije	Amsterdam
Hendrik Engelinus Weijers	Winkel
J. Ackersdijck	Hertogenbosch
E.J. Potgieter	Zwolle
Jacob Pieter van Walrée	Amsterdam
S.J. van den Bergh	Den Haag
J.P. Arend	Amsterdam
Herman Pol	Hengelo
A.L.G. Bosboom-Toussaint	Alkmaar
Willem Gerard Brill	Leiden
Joël Emanuel Goudsmit	Leiden
S. de Visser S.zoon	
J.I.D. Nepveu	Utrecht
L.Ph.C. van den Bergh	Düsseldorf
Johannes Gerardus la Lau	Leiden
J.J.A. Goeverneur	Hoevelaken
Conradus Leemans	Zaltbommel
Jan van der Hoeven	Rotterdam
Cornelis Star Numan	Sappemeer
Montanus de Haan Hettema	Bolsward
Taco Roorda	Britsum
John Bake	Leiden
Johan de Wal	Franeker
Jacob Geel	Amsterdam
André van Hasselt	Maastricht
J.F. Oltmans	Den Haag
A.L. Lesturgeon	Venlo
Willem Ernst Johan Berg	Amsterdam
Hendrik Jan Nassau	Middelburg
Wopke Eekhoff	Leeuwarden
H.F. Cohen	Haarlem
Henricus Bernardus Martini van Geffen	's-Hertogenbosch
Petrus de Raadt	Antwerpen
Leigh Hunt	Londen
Willem Moll	Dordrecht
Johan Rudolph Thorbecke	Zwolle
Hendrik Chistiaan Millies	Den Haag
Adriaan Beeloo	Den Haag
A.W. Engelen	Valburg
Bartholomeus Philippus de Kanter	Aardenburg
Levy Ali Cohen	Meppel
W.J.A. Jonckbloet	Den Haag
J. van Vloten	Kampen
W.C.L. Clarisse	Harderwijk
R.C. Bakhuizen van den Brink	Amsterdam
Henry Wadsworth Longfellow	
Joost Hiddes Halbertsma	Grouw
R.P.A. Dozy	Leiden
P.T. Helvetius van den Bergh	Zwolle
Friedrich Kaiser	Amsterdam
J. van Geuns	Amsterdam
Jan Gerhardus Ottema	Doetinchem
Gerrit de Clercq	Amsterdam
Johannes Kneppelhout	Leiden
C.J. van Assen	Harlingen
Gerardus Arnoldus Nicolaus Allebé	Amsterdam
C.W. Opzoomer	Rotterdam
Johannes Aletta Marinus Mensinga	Utrecht
Abraham des Amorie van der Hoeven jr.	Rotterdam
S. Vissering	Amsterdam
Martinus des Amorie van der Hoeven	Rotterdam
Dionys Burger	Rotterdam
Carl Ludwig Blume	Braunschweig
Willem Louis de Sturler	Tiel
Willem Leonard Ritter	Haarlem
C.H.D. Buys Ballot	Kloetinge
Jacobus Izaäk Doedes	Langerak
Jacob Dirks	Leeuwarden
F.C. Donders	Tilburg
Jan van Gilse	Zaandam
Johannes ab Utrecht Dresselhuis	Kampen
Georges Declercq	Zwevegem
Jacques François Bosdijk	Goes
A.J. de Bull	Amsterdam
Isaäc da Costa	Amsterdam
M.M. von Baumhauer	Brugge
T.W.J. Juynboll	Rotterdam
G.E. Voorhelm Schneevoogt	Haarlem
Henry Riehm	Deil
P. Halbertsma	Bolsward
Joannes Jacobus de Hollander	Aartswoud
T.K.M. von Baumhauer	Brussel
E. Piaget	
D.D. Büchler	
Willem Richard Boer	Rotterdam
J.J. Belinfante	Amsterdam
Jacques Clement Perk	
E.W. Beth	Almelo
J.J. Viotta	Amsterdam
P.A. de Génestet	Amsterdam
J.J. Rovère van Breugel	
Dirk Harting	Rotterdam
J.C.G. Evers	Den Haag
Carel Adriaan Engelbregt	Breda
Jan Heemskerk Bzn.	Amsterdam
E.B. Swalue	Standdaarbuiten
G. Knoop	
Christiaan Lodewijk Schuller tot Peursum	Oud-Alblas
J. Pijnappel	Amsterdam
J.A. Alberdingk Thijm	Amsterdam
David Bierens de Haan	Amsterdam
W.R. van Hoëvell	Deventer
Pieter Leendertz Wz.	Amsterdam
Mark Prager Lindo	Londen
Jacob van Lennep	Amsterdam
A.C. Oudemans	Dordrecht
Johannes Zeeman	Numansdorp
Lodewijk Willem van Deventer	Den Haag
Aug. Philips	
Jakob Karel Willem Quarles van Ufford	Rijswijk
Hendrik Jan Spijker	Amsterdam
Johan Carl Zimmerman	Batavia
H.J. Schimmel	's-Graveland
H.J. van der Helm	
Jacob Leonard de Bruyn Kops	Haarlem
Jacob de Witte van Citters	Den Haag
Ernst Julius Kiehl	Den Haag
W.J. Hofdijk	Alkmaar
F.M. Cowan	Londen
J.G.A. Faber	
Johannes Adriaan Molster	Amsterdam
Henriette Frederika Bosscha	Deventer
Hendrik Jacob van der Heim	Middelburg
C.L. van Woelderen	Vierlingsbeek
Louis Susan Pedro Meyboom	Emden
Daniel Koorders	Maarssen
L.M. Heemskerk	
J.L. Dusseau	Graveland
Marinus Lodewijk van Deventer	Den Haag
A. Rientjes	
S.J. Hoekstra	Haskerdijken
Arie de Jager	Delfshaven
Gozewinus Acker Stratingh	Adorp
Winand Carel Hugo Staring	Wildenborch
H.W. de Graaf	
Pieter Arend Leupe	Haarlem
Guillaume Henri Marie Delprat	Den Haag
C.C. Huysmans	Breda
H. van Cappelle jr.	Amsterdam
Elise van Calcar	Amsterdam
Theo Hermans	
F.J. Swartwout	
Cornelis Hooyer	Arnhem
Daniël Veegens	Haarlem
Johannes Bosscha	Harderwijk
L.J. Egeling	Haarlem
Pieter de la Court	Leiden
Johan de Witt	Dordrecht
J. Tideman	Alkmaar
F.A.W. Miquel	Neuenhaus
D.J. Coster	Amsterdam
Carl A.X.G.F. Sicherer	Rottweil
Adriaan Loosjes	Haarlem
Jan Herman Herman de Ridder	Culemborg
Joannes Tideman	Amsterdam
H. van Cappelle	Amsterdam
Jan Willem van der Noordaa	Dordrecht
Samuel Adrianus Naber	Den Haag
Willem Doorenbos	Deersum
H. Halbertsma	Sneek
P.J. Hollman	Antwerpen
Antonius van der Linde	Haarlem
Cornelius Marinus de Jong van Rodenburgh	Vught
Mari Johan Mees	Deventer
Lodewijk Willem Ernst Rauwenhoff	Amsterdam
J.C. Reepmaker	
Jan Jacob de Gelder	Den Haag
L. de Hartog	Gorinchem
Johan Adam Wijnne	Hoogeveen
E. van der Ven	Edam
Jan Pieter Nicolaas Land	Delft
Jan Gerrit Hulleman	Utrecht
Nicolaus Meursinge	
Antony Winkler Prins	Voorst
J.W. Muller	Amsterdam
Wilhelm Christiaan Knottenbelt	Mijnsheerenland
C.P. Tiele	Leiden
Carel Vosmaer	Den Haag
Geert Berings	
N.W.P. Rauwenhoff	
Johannes Margadant	Den Haag
Simke Heerts Rinkes	Joure
Abraham Kuenen	Haarlem
C.P. Burger	Gouda
Walter Bosch	
Nicolas Charles Sieburgh	Amsterdam
Robert Fruin	Rotterdam
Aart Veder	Rotterdam
B.W. Wttewaall van Wickenburgh	Utrecht
W.C.A. Staring	Laren
A.S. Carpentier Alting	Purmerland
Abraham Seyne Kok	Amsterdam
P.J.B.C. Robidé van der Aa	Oosterbeek
J. Wttewaall	Utrecht
W. Ruys	Ouderkerk aan de Amstel
Frederik Nagtglas	Utrecht
P.C. Margadant	Den Haag
Sijo Kornelius Thoden van Velzen	Oudkerk
Hendrik de Veer	Sommelsdijk
W.J.A. de Witt Huberts	Harderwijk
Nicolaas Jacob Bernard Kappeyne van de Coppello	Den Haag
T.T.H. Jorissen	Utrecht
Mon Steyaert	
H.P.G. Quack	Zetten
S.J. Hingst	Amsterdam
Johan Willem Tydeman	Leiden
Abraham Dirk Loman	Den Haag
Johannes van Dam	Utrecht
Samuël Senior Coronel	Amsterdam
Hippoliet Bauduin	Brussel
Tobias Michael Carel Asser	Amsterdam
Simon Frederik Groen	Maastricht
F.P.J. Sibmacher Zìjnen	Zaltbommel
T.J. Halbertsma	Deventer
Steven Blaupot ten Cate	Noordbroek
Johannes Philippus Heukelom	Amsterdam
W.H. van de Sande Bakhuyzen	
Abraham Willem de Klerck	Utrecht
Willem baron van Goltstein	Hamburg
Julius Christiaan van Deventer	Amersfoort
Otto van Rees	Luik
J. Limburg	
Eelco Verwijs	Deventer
Firmin van der Poorten	Aalst
Lodewijk Mulder	Den Haag
N.J. den Tex	Amersfoort
L.R. Beynen	Den Haag
Herman Agatho des Amorie van der Hoeven	Amsterdam
Pieter Bleeker	Zaandam
J.F.B. Baert	Harmelen
J. Beckering Vinckers	Winschoten
Samuel van Houten	Groningen
Gerrit Kuyper Hzn	Amsterdam
P.A. Tiele	Leiden
Thomas Kroon JHz.	Zutphen
Henri Ernest Moltzer	Wassenaar
R.S. Tjaden Modderman	
H.A. Wijnne	Hoogeveen
Isaäc Dornseiffen	Utrecht
Jan Willem Nicolaas Mosselmans	Loosduinen
Izaak Jan Blaupot ten Cate	Uteringeradeel
Nicolaas Bernhardus Donkersloot	Deventer
Michiel Johannes de Goeje	Dronrijp
Piet van Os	Breede
Jan Luzac	
Anthony Ewoud Jan Modderman	Winschoten
Jan ten Brink	Appingedam
B.J. Stokvis	
Jacob Gijsbert de Hoop Scheffer	Den Haag
M.H. Jansen	Antwerpen
D. Huizinga	Den Burg
B.H.C.K. van der Wijck	Gorinchem
Bernard Dominicus Hubertus Tellegen	Groningen
Hendrik Adriaan Antonius van Berckel	Delft
Julius de Geyter	Lede
J.A. van Dijk	Den Haag
Folkertinus Nicolaas Sickenga	Wolvega
H.W. Schroeder van der Kolk	
H. Neubronner van der Tuuk	
Jan Willem Straatman	Groningen
H.T. Karsten	
Jeronimo de Vries	Amsterdam
H.F.R. Hubrecht	Vlaardingen
W.F.R. Suringar	Leeuwarden
A.J.A. Gerlach	Groningen
A.W.M. van Hasselt	
A.E. Croockewit	Amsterdam
Jb. Boeke	Amsterdam
A. Quak	
H. van der Hoeven	
Cornelis Marinus Francken	Muiden
J.C. de Vries	
Meinardus Siderius Pols	Den Haag
M.T.H. Perelaer	Maastricht
R.P. Mees Azn.	Rotterdam
G.H.J. Elliot Boswel	Amsterdam
W.C.D. Olivier	
Henricus Oort	Eemnes
Joanan Rutgers	
Charles Boissevain	Amsterdam
M.W.C. Gori	Amsterdam
Johan Gram	Den Haag
Willem Johannes Franciscus Nuyens	Avenhorn
Hendrik Hooyer	Zaltbommel
D.J. Mom Visch	
Michaël Wilhelm Scheltema	Amsterdam
Peter van Bosse	Amsterdam
J. l' Ange Huet	Haarlem
W.A. van Rees	Arnhem
Matthijs Salverda	Appingedam
E.J.P. Jorissen	
Gerard Keller	Gouda
François de Casembroot	Luik
W.P. Sautijn Kluit	Amsterdam
Isaac Arnold Lamping	Sprang
H.C. Rogge	Amsterdam
Anton Gillis Cornelis van Duyl	Brielle
M.A.N. Rovers	Franeker
J.J. Cornelissen	Steenwijk
A.L.H. Ising	Heusden
Tobias van Westrheene Wzn	Delft
G.M. Boissevain	Amsterdam
George Lodewijk Kepper	Amsterdam
H.P. van Karnebeek	Amsterdam
H. van Herwerden	Beetsterzwaag
Cornelius Marius Kan	Groningen
J.S.G. Gramberg	Maastricht
C.J.F. Mirandolle	Paramaribo
H.C. van Hall	
T.J. Stieltjes	Leuven
P.J.W. Teding van Berkhout	Olst
Hendrik Pierson	Amsterdam
Peter van Os	
Willem Pieter Wolters	Leiden
Adriaan van Eck	Hontenisse
Sadi de Gorter	
G.A. van Hamel	Haarlem
Cornelis Bellaar Spruyt	Kockengen
P. van Geer	Leiden
Jan Karel baron van Goltstein	Arnhem
Balthazar Heldring	Hemmen
Martinus Leopold	Groningen
M.H. du Croo	Arnhem
Victor de Stuers	Maastricht
Philip Reinhard Hugenholtz	Woudenberg
Willem Arnold Pieter Pistorius	Velp
B. Carsten	Assen
Aart Admiraal	Goedereede
Pieter Marinus Netscher	Rotterdam
Jean Baptist van Hugenpoth tot den Beerenclauw	Boxmeer
Bruno Jz. Tideman	Rotterdam
Johannes Bodel Nijenhuis	Amsterdam
Johan Hermann Christian Heyse	Amsterdam
D. de Loos	Rotterdam
S.M.S. de Ranitz	
A.J.C. Geerts	
Hugo Beyerman	Deventer
H.J. van Ankum	Groningen
Pieter Heering	Enkhuizen
W.A. Verschuer	Den Haag
W.C. Hojel	Soerabaya
W. Heineken	
H.Q. Janssen	Sint Anna ter Muiden
A.C. Loffelt	Utrecht
Jan Willem Gerbrandt van Oordt	Utrecht
Ocko Wicher Star Numan	Groningen
P. de Boer	Holwerd
L.M.J. Glasius	
H. van de Stadt	
M.C.L. Lotsij	
Jacob Dirk Veegens	Den Haag
A.P.C. van Karnebeek	
Jan Hartog	Westzaan
W.K. van Dedem	Heerde
Floris der Kinderen Fzn.	Amsterdam
Joan Frederik van Oordt	Kaapstad
Adriaan Huet	Amsterdam
Barthold Jacob Lintelo de Geer van Jutphaas	Utrecht
Daniël Hartevelt	Brielle
Elise Adelaïde Haighton	Amsterdam
Constantijn	Semarang
J.H.F. Sollewijn Gelpke	Weltevreden
Tijs Terwey	Zaandam
Gerardus Petrus Booms	Maastricht
Pierre Joseph Henry Baudet	Zwolle
C.A. Crommelin	Nieuwer-Amstel
P.J. Cosijn	Rijswijk
A.T. Reitsma	
Taco H. de Beer	Maarsseveen (Maarssen)
J.L. Hoorweg	
Jeronimo de Bosch Kemper	Amsterdam
Annaeus Frederik Eilerts de Haan	Olst
Frederik Christiaan de Brieder	Almelo
Rudolf Cornelis Hendrik Römer	Oudewater
D.W. Rost van Tonningen	
F.V.H.A. de Stuers	Roermond
C.D.H. Schneider	Grave
Willem Bernard Johannes van Eyk	Utrecht
J.C. de Marez Oyens	
Ewaldus Daniël Pijzel	Dordrecht
M. de Ras	Nijmegen
Henrick Witte	Rotterdam
M.C. Piepers	
A. Elink Sterk jr.	Amsterdam
J.A.F.L. van Heeckeren	Zutphen
Pieter de Jong	Nieuwveen
F.H. Boogaard	
Willem Hendrik de Beaufort	Leusden
Willem Degenhardt	Amsterdam
Johan Hendrik Gallée	Vorden
Margaretha Wijnanda Maclaine Pont	Hasselt
Samuel Muller Fzn.	Amsterdam
C.M. Vos	Amsterdam
Petrus Conradi	Oudenhoorn
Johan Drabbe	Bergen op Zoom
W.B.G. Molkenboer	
F.J. Haver Droeze	Vlaardingen
Adrianus Dirk de Vries	Amsterdam
Adrianus Daniel de Vries	Amsterdam
A.C. Vreede	Gorinchem
Henricus Anastasius Viotta	Amsterdam
L.A.J.W. baron Sloet van de Beele	Voorst
Th.W. Engelmann	Leipzig
A.H.G.P. van den Es	Sassenheim
I.D. Franssen van de Putte	Goes
Jacobus Craandijk	Amsterdam
J.J. van Toorenenbergen	Utrecht
J.J. Meinsma	Leeuwarden
Johan baron d' Aulnis de Bourouill	Groningen
J. van Loenen Martinet	Nijmegen
Jacob Léon Wertheim	Amsterdam
Johannes de Koo	Middelie
J. Winkler Prins	Tjallebert
J.G. Frederiks	Duinvliet bij Oostkapelle
R.M. van Goens	Utrecht
Jacob Hendrik Hora Siccama	Utrecht
D.C. Meijer	Amsterdam
V.A. Julius	Utrecht
J. Aleida Nijland	Hoorn
Jacob Adolf Bruno Wiselius	Amsterdam
Anthonie Marius Kollewijn	Gouda
E.O. Houtsma	
C. Terburch	Buitenzorg
Jean Charles Naber	Haarlem
J.C. Costerus	Sneek
G. Kalff	Zwolle
G. de Bosch Kemper	Amsterdam
Emile Habets	
Daniël de Lange	Rotterdam?
Maurits Smit	
T.H.F. van Riemsdijk	Maastricht
Nicolaas de Roever	Amsterdam
F.P. ter Meulen	
A.L. de Rop	Den Haag
C. Honigh	Koog a/d Zaan
A.C. Waller	
[tijdschrift] Vaderlandsche Letteroefeningen	
H.E. Beunke	Middelburg
Jan de Louter	
H.G. Roodhuyzen	
Melchior Treub	Voorschoten
L.R. Koolemans Beynen	Den Haag
Anth. Grolman	Utrecht
G.E. Langemeijer	Dieren
K.W. van Gorkom	
Albert Jan ten Brink	Appingedam
Frederik van Hogendorp	Den Haag
H.L. Berckenhoff	Purmerend
H.U. Meyboom	Hornhuizen
Henri Raloff	
A.L.W. Seyffardt	
M. van Andelst	
J.C.M. van Riemsdijk	
J.J.L. ten Kate	Den Haag
Anton Gerard van Hamel	Haarlem
Robert Macalester Loup	Elst
Anne Busken Huet-van der Tholl	Haarlem
Jacob de Witt	Dordrecht
Johannes Reitsma A.Tzn.	Oudemirdum
Gerrit de Vries	Haarlem
A.S.C. Wallis	Utrecht
Jan Philip de Bordes	
Max Rooses	Antwerpen
L.A.J. Burgersdijk	Alphen aan den Rijn
Petrus Martinus Bots	Nieuwkoop
A.E.J. Holwerda	
David van Hoogstraten	Rotterdam
Carl Ludwig Lütkebühl jr.	Amsterdam
T.M. Tromp	
Virginie Loveling	Nevele
J. Röell	Haarlem
J.D. de Jong	Den Haag
R. Feith	Appingedam
François de Bas	Den Haag
H. Koekebakker	Wormerveer
Pol de Mont	Wambeek
A.A.W. Hubrecht	
J.A. Worp	Almelo
Gerard Valette	
J.A. Bientjes	Hellevoetsluis
Gerard Heymans	
A.J.W. Farncombe Sanders	Medemblik
Joh. Dyserinck	Haarlem
George Eliot	Warwickshire
L. de Vlaming	
H.L.F. Pisuisse	Rotterdam
Jan van Beers	Antwerpen
Hermannus Bouman	Groningen
J.H. Hooijer	Zaltbommel
Anthony Beaujon	Den Haag
M.A. Perk	Delft
Jac. Moleschott	Hertogenbosch
Johannes Hermanus Gunning jr.	Vlaardingen
W.C. Mees	
H.L. Drucker	Amsterdam
R.P.J. Tutein Nolthenius	Abcoude
E.B. Kielstra	Leeuwarden
B. Sijmons	Rotterdam
Constantinus Bake	Amsterdam
Josephine Giese	Den Haag
Louis Couperus	Den Haag
Willem Pleyte	Hillegom
J.W. van der Linden	
Hijman Binger	Amsterdam
Jan Carel Matthes	Noordeloos
Jacob Kuyper Hzn.	Rotterdam
Jan Izaak van Doorninck	Deventer
Martina Geertruida Sara van der Feen	Middelburg
M.E.F. Elout van Soeterwoude	Den Haag
W. Gosler	Tilburg
Hélène Swarth	Amsterdam
A. Bruining	Pietersbierum
P.A.M. Boele van Hensbroek	Den Haag
Fiore della Neve	Leiden
J.P. Hasebroek	Leiden
J.C. Loman jr.	Amsterdam
Pieter Gerard van Schermbeek	Elst
Abraham Bredius	Amsterdam
P.W.A. Cort van der Linden	Den Haag
Pierre Daniel Chantepie de la Saussaye	Leeuwarden
C.H. den Hertog	Den Haag
Marie Agathe Boddaert	Middelburg
J.J.P. Valeton	Groningen
W.C. van Manen	Noordeloos
B. Dorhout Mees	Garmerwolde
Willem van der Vlugt	Haarlem
Theodoor Carel Gobée	's-Hertogenbosch
F.S. van Nierop	
A.W. Kroon-Star Numan	
Arnold Werumeus Buning	Uithuizen
Frans Netscher	Den Haag
Geertruida Carelsen	Haarlem
Jan Six	
F.J.L. Krämer	
Henri David Levyssohn Norman	Den Haag
Christiaan Snouck Hurgronje	Oosterhout
Adriaan Pit	Den Haag
Elise Knuttel-Fabius	Batavia
Albartus Telting	Leeuwarden
Johannes Mulder	
Joan Bohl	Zierikzee
S.E. Harthoorn	
Willem Pieter Cornelis Knuttel	Maassluis
G.W. Bruinsma	Leeuwarden
Albertus Hendrikus Nijland	Varsseveld
Matthias de Vries	Haarlem
Louis Trenard	Port-Vendre
Gerard Slothouwer	
Charles François van Duyl	Zierikzee
Emile Seipgens	Roermond
Th. Swart Abrahamsz	
Willem A. Hecker	Groningen
Willem Jacob Manssen	Kampen
J.H. Kips	Den Haag
George Alexander Wilken	Menado
N.J. Singels	Leeuwarden
Samuel Muller	Krefeld
Herman Frederik Carel ten Kate	Amsterdam
Pieter Nicolaas van Kampen	Leiden
A. Kluijver	Koog a/d Zaan
Frits Lapidoth	Ursem
Jan F. Beekman	
J.H. van den Bosch	Zwolle
J. Menno Huizinga	
J.J.A.A. Frantzen	
J.E. Sachse	
H. Was	
H.J. Polak	Leiden
Marcellus Emants	Voorburg
W. Jaeger	
C.A. Steger	Den Haag
J.A. Tours	
Izaak Jan le Cosquino de Bussy	Utrecht
J.B.C. Adriaensen	Brussel
Jacob Samuel Speyer	Amsterdam
W.L. Penning	Schiedam
R.A. Kollewijn	Amersfoort
N.P. van den Berg	
Johanna A. Wolters	
C.C. Uhlenbeck	
G.J. Boekenoogen	Wormerveer
L.W.C. van den Berg	Haarlem
A.J. Immink	
P.J. Blok	Den Helder
Leo Simons	Den Haag
H. J. Eymael	Heerlen
G.H. Priem	
S.J. Warren	
K.O. Meinsma	Deventer
J.H. Groenewegen	
J.F. van Bemmelen	Groningen
Leopold	Leiden
A.J. Bothenius Brouwer	Veendam
J.G. Gleichman	Rotterdam
Hendrik Barend Greven	Rotterdam
Bernhard van Meurs	Nijmegen
Wolfgang Brandt	
Jan Frederik Niermeyer	
Salomon Müller	
R.C. Boer	Warnsveld
Willem Frederik Andriessen	Den Ilp
Herman Heijermans	Rotterdam
C.A.J.A. Oudemans	
L. Knappert	Harlingen
Edward B. Koster	Londen
Marie Snijder van Wissenkerke	
Arnoldus Nicolaas Jacobus Fabius	Goor
M. Straub	
Samuel Kalff	
J.P. Moltzer	
H. Logeman	Haarlem
Willem Bilderdijk	Amsterdam
S.R. Steinmetz	
B.J.H. Ovink	
J.E. Enklaar	Doesburg
Frans Coenen	Amsterdam
Elie van Rijckevorsel	Rotterdam
Philippe Zilcken	Den Haag
A.W. Pulle	
Jan Veth	Dordrecht
Joannes van der Vliet	Reeuwijk
L. Serrurier	Dordrecht
Nicolaas Dirk Doedes	Rotterdam
Betsy Juta	
August Gittée	Gent
Willem Gerard van Nouhuys	Zaltbommel
J.F.D. Blöte	
Ch.M. van Deventer	Dordrecht
C.H.H. Spronck	
F.V. Engelenburg	Arnhem
Gerard Vissering	
H.Z. Zegers de Beijl	Garderen
Frederike J. van Uildriks	Groningen
H.S.M. Wickevoort Crommelin	
Philippus Samuel van Ronkel	Zutphen
J.H. van 't Hoff	Rotterdam
A.G. van Hamel	Hilversum
H. Heukels	
G.F. Haspels	Nijmegen
Willem Duflou	Gent
C. Winkler	
Jan Marcus Hoogvliet	Schiedam
C.A. Pekelharing	
H.Y. Groenewegen	
Foeke Buitenrust Hettema	Harlingen
W.L.P.A. Molengraaff	
Ida Heijermans	Rotterdam
Jacob Gerard Patijn	Wadenoijen
W.M. Engelberts	
H.A. Lorentz	Arnhem
H. Zwaardemaker	Haarlem
Augusta de Wit	Sibolga (Sumatra)
Hendrik Clemens Muller	Amsterdam
L.J. Plemp van Duiveland	Rotterdam
J. Mathijs Acket	Hertogenbosch
G. den Tex	
H. Tz. Pyttersen	
Johan Hora Adema	Holwerd
Maurits Wagenvoort	Amsterdam
Carel Scharten	Middelburg
C.A.E. Wichmann	Hamburg
Frank van der Goes	Amsterdam
M.W.F. Treub	Voorschoten
B.D. Eerdmans	Maasdam
W.Ph. Scheuer	Rotterdam
Joh. H. Been	Brielle
H.A. Kooyker	Amsterdam
F. Beelaerts van Blokland	Den Haag
G.H. Marius	
G.J. Kolff	
H.W.Ph.E. van den Bergh van Eysinga	Den Haag
Hendrik Doeff	Amsterdam
O.M. de Munnick	Batavia
Anna van Hogendorp	Den Haag
J.H. van den Broek	Breda
Gerrit Halfcaegh	
Gianni Riotta	Palermo
J.W. Doyer Jz.	
G.P. Rouffaer	
Margo Scharten-Antink	Zutphen
A.W. Byvanck	Leiden
Johannes Hermanus Gunning J. Hzn.	Hilversum
D.G. Jelgersma	
Margaretha Meijboom	Amsterdam
D.E. Siegenbeek van Heukelom	Poederoijen
D. Simons	
Egberdina Anna Junius	Letjesbosch
F.A.F.C. Went	
Julius de Boer	Malang
Gerrit van Gorkom	Zutphen
Hendrik Johan Haverman	
L.S. Meijer	
Aletta H. Jacobs	Sappemeer
Paul François Hubrecht	Leiden
Charlotte van Herwerden	
C.H.Th. Bussemaker	Deventer
L.E. Visser	
Anna Ekker	
Conrad Th. van Deventer	Dordrecht
Judith Viorst	Newark (New Jersey)
Frans Mijnssen	Amsterdam
Ida Haakman	
Nellie van Kol	's-Hertogenbosch
Fleur Bourgonje	Achterveld
Anna Germonprez	Oudenaarde
M. Tonnet	
Gerard van Eckeren	Haarlem
M.J. Pijnappel	Amsterdam
Aloysius Brouwer Ancher	Amsterdam
Hugo Krabbe	Leiden
J.W. Jenny Weijerman	
P.C. Boutens	Middelburg
Bas Veth	Amsterdam
C.H. Kühn	
J.C. van Leyden	
W.P. Kops	Utrecht
S. van Aken	
G.H. Betz	Rotterdam
A.D. van Assendelft de Coningh	Bergen op Zoom
J. Marx	
Bernard Gewin	Rotterdam
C.G.S. Sandberg	
T.J. de Boer	Wirdum
J. Eigenhuis	Aalsmeer
C.A. Worp-Roland Holst	
Arnoldus Wilhelmus Stellwagen	Norg
J.H. de Veer	Delft
G.H. van Waveren jr.	
N. Mansvelt	Wassenaar
J.C.G. Grasé	
Guido Gezelle	Brugge
H. van Hogendorp	
Gijsbert Karel graaf van Hogendorp	Rotterdam
Johannes Hasselman	Nederhemert
Marie Metz-Koning	Amsterdam
Gerard van Hulzen	Zwolle
H.R. Offerhaus	
J.E. Jasper	
J.J.G. Vürtheim	
Richard de Cneudt	Gent
E. van Hille	
J.P. van Rossum	
C.K. Elout	Utrecht
J. Mar. Ruys	
Maurice Wilmotte	Luik
J.A. Simons-Mees	Rotterdam
Antoon Derkinderen	Hertogenbosch
P.J. van Löben Sels	
A.W. Nieuwenhuis	
I. Kooistra	
G.P. Bakker	
P. Leendertz (jr.)	
B. Symons	
Willem Lodewijk van Helten	Hedel
Alfred Listal	
Gideon Busken Huet	Haarlem
L.N. de Jong	
Dan. Engelen	Nijmegen
F.J.L. Rompel	Amsterdam
H.G. van der Vies	Amsterdam
T.J. Bezemer	Delfshaven
J. Everts	Utrecht
Maria Muller-Lulofs	Amsterdam
Paul Fredericq	Gent
Elizabeth Visser	
Israël Querido	Amsterdam
Gerrit Simons	Utrecht
Louis Carbin	Margarethenburg
Theodoor Bernard van Lelyveld	Semarang
Johanna Naber	Haarlem
Martina G. Kramers	
C.B. Hylkema	Akkrum
G. van Rijnberk	
N. van Wijk	Delden
W. de Vletter	
M.J. Brusse	Amsterdam
Hélène Mercier	Amsterdam
D. Bos	Groningen
H.L. Oort	
Pieter Corbeels	Leuven
Johannes Everts jr.	Kralingen
F. de Haan	Leeuwarden
F.A. van Engen	
L.F. de Beaufort	Leusden
Sara Bouterse	
J.H. Blankert	Ouddorp
Hendrik Mulder	
Wilhelmus Johannes Kühler	Amsterdam
G.A. van den Bergh van Eysinga	Den Haag
W.E. van Dam van Isselt	Bergen op Zoom
Johan Christiaan van Eerde	Workum
W. Vollgraff	
G. Polvliet	
Ch.F. Haje	
A. Hotz	
Sam Goudsmit	Kampen
A. Kluyver	
L.H. Grondijs	Pamekasan
Jan Limburg	
Karel Vos	Rotterdam
Jozef Israëls	Groningen
Tine van Buul	Rotterdam
Martha Johanna Hamaker	
A.E. Thierens	Monnickendam
Gustaaf D' Hondt	Sint-Denijs-Westrem
J.J. Salverda de Grave	Noordwijk
J. de Jager	
J.W.T. Cohen Stuart	Surakarta
H.J. Hamburger	
W.H. Hasselbach	
J.M. Hoogvliet	Spaarndam
J.H. Deibel	
Nicolaas Japikse	Joure
A.J.G. Maclaine Pont	Jakarta
Anna van Gogh-Kaulbach	Velsen
Louis Havet	
J. van den Bergh van Eysinga-Elias	Amsterdam
M.H. Lem	
A. Meyroos	
J. Hobma	
I. Zeehandelaar	
H.P. Staal	Zwolle
J. Boudewijnse	Den Haag
J.D.C. van Dokkum	
Leo van Puyvelde	Sint-Niklaas
Martinus Poelhekke	
Samuel Pierre l' Honoré Naber	Zwolle
Jan Jacob Thomson	Bredevoort
F. Schmidt-Degener	Rotterdam
Arthur van Schendel	Batavia
Johannes Aarnout Loebèr jr.	
J.H.F. Kohlbrugge	
H. Buringh Boekhoudt	Delfzijl
Nico Oosterbeek	
Th. van Ameide	Ameide
P.N. van Eyck	Breukelen
C. te Lintum	Winterswijk
O. Oppermann	
Herman Robbers	Rotterdam
P. van Romburgh	
S. Bonn	Amsterdam
Hendrika Boer	
J.A. van Hamel	Amsterdam
Pieter Valkhoff	Heerenveen
Geerten Gossaert	Kralingen
Rommert Casimir	Kollum
Johannes Benedictus Kan	Groningen
Eltjo Aldegondus van Beresteyn	Haarlem
William Davids	
Johanna Westerdijk	Nieuwer-Amstel
H.G. van der Waals	
G.J. Nieuwenhuis	
Dorothée Buys	
Jacob Israël de Haan	Smilde
Adriaan van Oordt	Dresden
E.M. ten Cate	Zwolle
J.H. Holwerda	
Herman Middendorp	Wolvega
Jan Jelles Hof	Gaastmeer
Nico van Suchtelen	Amsterdam
Multatuli	Amsterdam
C.J. Hasselman	
J. Prinsen J.Lzn	Hertogenbosch
Willem Meijer	Amsterdam
F.M. Wibaut	Vlissingen
Herman Baccaert	Mechelen
J.Ph. Vogel	
H.N. de Fremery	
Jac. P. Thijsse	Maastricht
J.B. Kan	Nijmegen
Jan Slingenberg	
H.F. Jonkman	
G.J. Heering	Pasoeroean
J.J. Tesch	Amsterdam
P. Otten	Den Haag
Coen Hissink	
J.J. Bekaar	
Wilhelm Loeb	Den Haag
Ina Boudier-Bakker	Amsterdam
Aart van der Leeuw	Delft
J.D. Bierens de Haan	Amsterdam
Nicolaas Messchaert	Hoorn
A.S. van Oven	
Just Havelaar	Rotterdam
Frederik Daniel Eduard van Ossenbruggen	
Hendrik Onnen	
Jan de Gruyter	Lekkerkerk
Johan Toot	
H.L. de Beaufort	Leusden
Richard Roland Holst	Amsterdam
Th.M. Roest van Limburg	Rotterdam
C.E. Hooykaas	Rotterdam
H. Burger	Delft
Willem Kalma	
J. Bosboom Nz.	
J. Philip van Goethem	
H.J. Westerling	
Jacobus Gerardus Veldheer	
Ernst Heldring	
Marie Loke	
J.C. Hol	
Johan van Meurs	
Peter Spaan	
N.H. Swellengrebel	Amsterdam
A.W. Weissman	Amsterdam
Anton Reinhard Falck	Utrecht
C. Kramer	
Leonie van Nierop	
C. Pekelharing	
J.J.B. Elzinga	Haarlemmermeer
Johan Wesselink	
J. Berlage	Amsterdam
H.P.N. Muller	Rotterdam
J. Rietema	Leens
Jan Overduin	Leiden
Gerrit Kalff jr.	Amsterdam
Jo van Ammers-Küller	Noordeloos
M.A. van Herwerden	
J.G. Sleeswijk	Den Haag
Frans Bastiaanse	Utrecht
A.W. van Renterghem	
François Pauwels	Amsterdam
Jan Prins	Rotterdam
P.F.H. Fromberg	Amsterdam
G.J. Hoogewerff	Amersfoort
J. de Wit	
F. de Sinclair	
Gerard van den Hoek	Leeuwarden
Jan J. Zeldenthuis	Westervoort
Frank Gericke	
Zadok Stokvis	Den Haag
A.H. Blaauw	Elst
Kornelis Sneyders de Vogel	Schiedam
G.C.J. Vosmaer	
C.A. van Manen	
C. Becker	Oldenzaal
F.E. Posthumus Meyjes	Amsterdam
F.W.J.G. Snijder van Wissenkerke	Middelburg
Matthée Corneille Valeton	
L.L.C.M. van Outhoorn	
Jan van Rossem	
Joseph Loopuit	Amsterdam
Halbe Binnerts	Heerenveen
Pieter Willem de Koning	
Jean-Pierre van Rossem	Brugge
Top Naeff	Dordrecht
A. van Collem	Rotterdam
Em. Querido	Amsterdam
Th. de Meester	Harderwijk
Tobie Goedewaagen	Amsterdam
W. Nolen	Rotterdam
Wally Moes	
P. van Schilfgaarde	
W. de Sitter	Sneek
Karel Wasch	Middelburg
Johan W. Schotman	Hoogeveen
Jac. D. Huizinga	Huizinge
S. Pinkhof	Amsterdam
A.A.H. Struycken	
A.J. Wensinck	
B.C.J. Loder	
Käthe Mussche	
K. Jansma	Amsterdam
Jac. van Looy	Haarlem
C.T. van Valkenburg	
S. Ritsema van Eck	
R. de Josselin de Jong	
Henri van Booven	Haarlem
Jelte Dijkstra	Grijpskerk
J.P. Kuenen	
J.J. Boasson	Middelburg
J.M. van IJssel de Schepper-Becker	Rotterdam
Adriaan J. Barnouw	Amsterdam
E. W. Holthuysen	
Petrus Raëskin	
M.J. Sirks	Rotterdam
Frits Hopman	Amsterdam
Dirk Merens	
Herman Lysen	
J. van Oudshoorn	Den Haag
Isidoor Teirlinck	Zegelsem
J. de Marees van Swinderen	Leeuwarden
R.A. Verweij	
Meint Joustra	Bolsward
E.C. van Dorp	Arnhem
W. Elink Schuurman	
A. van Hengel	
G.F.E. Gonggrijp	
Multavidi	
W.B. Kristensen	
H. van Loon	
Dan. de Lange jr.	
C. Lekkerkerker	
J. Rietsema	
Marie Schmitz	Haarlem
H. Oort	
J.A. Eigeman	
A.H.M.J. van Kan	Maastricht
Martin Albers	
A.C. Josephus Jitta	
K.H. Roessingh	Groningen
G. Titta Rosa	L'Aquila
S.H. de Roos	Drachten
Laurens van der Waals	Utrecht
Henriette Laman Trip-de Beaufort	Baarn
Andrew de Graaf	Rotterdam
Simon van Brakel	Dordrecht
P.C.J.A. Boeles	Assen
Job Steynen	Gouda
Emmanuel de Bom	Antwerpen
Madeleine Böhtlingk	Arnhem
Herman Poort	Stadskanaal
Cornelis Veth	Dordrecht
D.M.G. Koch	
Timon Hendrik Fokker	Batavia
A.J. de Sopper	Brugge
Herman Frijda	Amsterdam
Marie Cremers	Amsterdam
C.A. Verrijn Stuart	Weesp
Jeanne van Schaik-Willing	Amsterdam
Jac. C. Bloem	Tilburg
Johannes van der Elst	Groningen
Hk. de Vries	
E.E. Gewin	Abcoude
J.A. Schroeder	
Is.P. de Vooys	Gouda
Antoon Thiry	Leuven
H.A. Enno van Gelder	Gouda
Marcus van Blankenstein	Ouderkerk aan den IJsel
Johan Fabricius	Bandung
Jo de Wit	Rotterdam
Henri Bakels	
Hendrika Ghijsen	Middelburg
F. Adama van Scheltema	
A. Geyl	
L. Ali Cohen	Semarang
Johan Huijts	Rotterdam
W.M.F. Mansvelt	Stellenbosch
Lode Baekelmans	Antwerpen
J.P. Fockema Andreae	Leiden
Edith Werkendam	Amsterdam
J. Faber	
Frits G. Tingen	
A.M. Hammacher	Middelburg
Isidoor van Beugem	Moorsel
Elisabeth Reitsma	Groningen
L.M.A. von Schmid	Maastricht
Sybrandi Braak	Aalsmeer
C.M. van Hille-Gaerthé	Zwolle
Petrus van Renesse	
André Jolles	Den Helder
E.F. Kossmann	St. Petersburg
D.Th. Jaarsma	IJlst
Gerbert Scholten	
E.C. Abendanon	Pati
F. Dijkema	Ezumazyl
J.P.A. François	Den Haag
H.H.J. Moulijn-Haitsma Mulier	
Nine van der Schaaf	Terhorne
Jo Landheer	Rotterdam
P. Verhagen Lzn.	
A.B. Droogleever Fortuyn	Rotterdam
J. Burger	
J.J.L. Duyvendak	Harlingen
Gerard Brom	Utrecht
J.A. Lambert-van der Kolf	
C. Bakker	Koog aan de Zaan
J. Bierens de Haan	Ootmarsum
J.W. Marmelstein	
Miek Janssen	Arnhem
G.J.D.C. Stempels	
Jenny Mollinger	
W. Kuenen	
J.M. Bottemanne	Leiden
Adriaan Daniel Fokker	Buitenzorg
Willem Leendertz	Veenwouden
Beatrice Willing	
J.J. van Loghem	
Frans Maurits de Jaeger	Den Haag
Jooske Brandeler-den Beer Poortugael	Den Haag
J. Aalbers	
C.W. van der Pot	Zevenbergen
Cornelia Serrurier	
J.P. Wesselink-van Rossum	
H.M.J. Oldewelt	
G.W.J. Bruins	Zutphen
G.J. Geers	Delft
Elize van Kaathoven	
J.H. Kramers	Rotterdam
Siegfried E. van Praag	Amsterdam
Teatse Eeltsje Holtrop	IJlst
A.M. de Jong	Oostburg
Constant van Wessem	Den Haag
Daniël Crena de Iongh	Dordrecht
Sybrand Allard Waller Zeper	Leeuwarden
G.H. Hintzen	
H. Enno van Gelder	Amsterdam
H.C. Hartevelt	
Albert Plasschaert	Sas van Gent
Johannes Tielrooy	Texel
Theodoor Jan Stomps	
H.L. van Oordt	
P. Verdoes	
W.E. van Wijk	Amsterdam
G.J.C.A. Pop	
René Klinkenbergh	
J.C. Baak	Nijmegen
A.S. Oppenheim	
P.E. van Renesse	
C.J. Wolterbeek	Steenderen
Agatha Seger	
H.L. van Duyl	Kampen
Willem de Mérode	Spijk
Lodewijk Franck	Antwerpen
D. Loenen	Nieuw-Loosdrecht
G.A. van Klinkenberg	Amerongen
J.W. Teillers	
F.C. Dominicus	Wemeldinge
Willem de Clercq	Amsterdam
E.D. van Dissel	Bladel
H. Ribbius	
P. Roosenburg	
W. Feuilletau de Bruyn	Palembang
W.H. Staverman	Twello
J.H. van Zanten	
Ferrad Whaley Hudig	Rotterdam
Willem van Doorn	Arnhem
A.G.N. Swart	
J. Reitsma	
H.T. de Graaf	Kollum
J.P. van Limburg Stirum	
G.J. Morsch	
J.E. van der Pot	Zwolle
C. Wolterbeek	
Arthur J.H. Cornette	Antwerpen
S.I. van Zuylen van Nyevelt	
D. Merens	
Boris Raptschinsky	
A.J. van der Steur	Haarlem
A. Plate	
W. Kramer	Westmaas
A.W.C. Zuidema	
Willem Pijper	Zeist
Wilhelm Martin	Quakenbrück
J.Z. Kannegieter	
Abraham Benjamin Cohen Stuart	Semarang
C. de Boer	Leiden
Reinier van Genderen Stort	Buitenzorg
N.J. Polak	
Johannes Lindeboom	Deventer
Matthijs Vermeulen	Helmond
Robert van Genechten	Antwerpen
B.G. Escher	Gorinchem
P.L. van Eck jr.	
C.J. Blaauw	Amsterdam
D.F. Slothouwer	
R.W.J. den Tex	
Herman Vos	Antwerpen
F.J.A. Huart	Delft
D.J. Sannes	
D. Dresden	Amsterdam
J.B. Manger	
J.A.J. Barge	Semarang
L.A. Alting Mees	
A.A.M. Stols	Maastricht
L.J. van Holk	Amsterdam
J.H. Plantenga	Rotterdam
T.J.C. Gerritsen	Hoogeveen
C.L. Heesakkers	Berlicum
Hermann Wolf	Keulen
B. van Geuns	Haarlem
Arnold Lysen	
Th. van Welderen Rengers	
Leendert van Lange	Rotterdam
E.A.N.P. Franchimont	
E. du Perron	Jatinegara
R.A.D. Cort van der Linden	Groningen
Pieter Zeeman	Zonnemaire
Kasper Niehaus	Groningen
Raymond Herreman	Menen
Maria van Royen	
F.G. Scheltema	Groningen
J.F. Kunst	
Fenna de Meyier	Indramajoe (Java)
C.H. van Os	Ambarawa
P.J. Fehmers	Rotterdam
Antoon Jacob	Boom
Antoon Gerard Roos	Groningen
Ben Onie	
L.G.M. Baas Becking	Deventer
Boudewijn Nierstrasz	
J.W. van Nouhuys	Leiden
Amand Simoens	Kortrijk
R. Wiarda	
Lien ter Laan-van Lokhorst	Valburg
M.A. Muusses	Purmerend
F.D.K. Bosch	Potchefstroom
H.A. Mulder	Zaamslag
August Vanhoutte	Oostende
Roelof Kranenburg	Groningen
J.M. de Casseres	Beverwijk
W.E.J. Kuiper	
Hendrik Brugmans	Amsterdam
Godard Gosses	Dokkum
Hermien Manger	Amsterdam
Willem van Maanen	Amsterdam
Jan Kalf	Amsterdam
J.M.J. Schepper	
Jérôme Decroos	Pollinkhove
Dirk Hudig	Rotterdam
Evert Willem Schallenberg	Rotterdam
C.M. Hamaker Sr.	
A.W. Grauls	Antwerpen
C. Binnerts	Meppel
W.J. van de Woestijne	Amsterdam
F.A. van der Hoeven	
I.J. Brugmans	Groningen
Ralph Springer	
F.A.J. Vermeulen	
A.C. Kersbergen	
C.J.J. Westermann	
Jan P.M.L. de Vries	Amsterdam
Jacob Haantjes	Renkum
H.G.J. Maas Geesteranus	
I.H. Gosses	Dokkum
Jan Carel de Haan	Soemedang
J. Zaaijer	
C. Tielrooy-de Gruyter	
Arie Zijderveld	Hendrik-Ido-Ambacht
David Jacob van Lennep	Flims
Christoffel Verwey	
G.A. Nauta	
A.A. Bake	Hilversum
Richard Minne	Gent
Han G. Hoekstra	Den Haag
Jaap van Gelderen	
W.L. de Vreese	Gent
Anny C.A. Alberdingk Thijm	
H.N. ter Veen	
J.A. Pollones	
J. Wolterbeek Muller	
Gerrit Besselaar	Rotterdam
Gabe van der Zee	Koudum
Wilhelmina Smit-van de Wall	
J.C.M. Warnsinck	Hoogwoud
N. Levi	
D. Cohen	Deventer
R.F. Beerling	Gorinchem
Jaap Kunst	Groningen
L. Kappeyne van de Coppello-Wijgers	
A. Feberwee	Deventer
Leo Plemp van Duiveland	Rotterdam
H.Th. de Booy	Den Helder
C.W. Roldanus	Den Haag
J.B. Besançon	Amsterdam
Barend ter Haar Bzn.	Eemnes
Jacoba Eggink	
C. Weststrate	Wemeldinge
Douwe Kalma	Boksum
André De Weerdt	Antwerpen
G.W.J. Drewes	Amsterdam
Henri Houben	
L.K. Wolff	
B. Vechtman	
Hugo de Groot	Delft
Emile Verviers	
A.N.J. den Hollander	
M.R.J. Brinkgreve	Utrecht
J.H. Pluvier	
P.C. Molhuysen	Almelo
D.J.H. ter Horst	
A.H. Philipse	
Paul Cronheim	Amsterdam
K.S. van Heynsbergen	
Kees van Bruggen	Den Helder
Garmt Stuiveling	Stroobos
Elisabeth du Perron-de Roos	
A.W. de Groot	Groningen
Klaas Heeringa	Ternaard
R.J. Kortmulder	
C.J. de Vogel	
Anton Koolhaas	Utrecht
Homerus	
J.J. von Schmid	
K.F.O. James	
A. Hendriks-Kappelhoff	Amsterdam
Ed Coenraads	Wageningen
Tine Brinkgreve-Wicherink	Alkmaar
B.M. Telders	Den Haag
Hermanus Arnoldus Idema	
Ar. Kwink	
P.J. van Winter	Utrecht
H.A.C. Snethlage	
Marion Duimel	Pijnacker
J.H. Scholte	
J. Steur	
A. Jager	
Sofia Antoniadis	Piraeus
Edgar Allan Poe	Boston
J.G. van Dillen	Amsterdam
Theodorus Ligthart	Amsterdam
Jan Daman	Middelburg
Gs. Finjee	Utrecht
Erik Hörnström	
M.H. Székely-Lulofs	Soerabaja
G. van der Leeuw	Den Haag
Aleksej Hackel	Sint-Petersburg
E.H. ter Kuile	
F.W.S. van Thienen	
Jan Hulsker	Den Haag
H. Hettema jr.	
C.D.J. Brandt	Utrecht
H.J. de Vleeschauwer	Dendermonde
J.F. Haccoû	
G. Knuttel Wzn	Den Haag
A.J. Bernet Kempers	Hertogenbosch
W.F. Prins	
Hajo Brugmans	Groningen
Chr. Cornelissen	Hertogenbosch
Maurits Sabbe	Brugge
W.J. Aalders	Amsterdam
Ph.J. Idenburg	Hillegersberg
Marie van Dessel-Poot	Vlaardingen
Johannes Rahder	Lubuk Begalung
Uys Krige	
J.R. van Blom	
Truus Gerhardt	Amsterdam
G. Knuttel jr.	Delft
Jan Willem Meyer Ranneft	Magelang
Frans Buyle	Sint-Niklaas
F.W. Prins	
Hermann Goetz	
Eline Canter Cremers-van der Does	Maassluis
H.N. Boon	Rotterdam
T. van der Zee	
Hendrik Riemens	
H. van der Tuin	Amsterdam
J.J. Schrieke	
Arnoldus Noach	
J.F. Niermeyer	
Eduard Reeser	Rotterdam
D.F.W. van Lennep	
J.N. Bakhuizen van den Brink	Joure
Lode Zielens	Antwerpen
F.L. Ganshof	Brugge
Johan Wesseling	
F.S. Knipscheer	Amsterdam
C.J. van Geel	Dubbeldam
P. Lascaris	
A.F. Zwaardemaker	
G.G. Kloeke	Schagen
J.P. Wiersma	Hallum
Herman Dirk van Broekhuizen	Rijssen
Willem Johannes Leyds	Magelang
S. Posthuma	
Stephan Ronart	
G.S. Overdiep	Vries
J.H. Boeke	Wormerveer
N.J. Krom	Hertogenbosch
C.F. Roos	
H. Drion	Den Haag
C.H. de Goeje	
A.L. Wurfbain	
J. Molemans	
G. Bolkestein	Amsterdam
A. Hollenberg	
F.M.P. Oosterhof	Kampen
W. Arondéus	Naarden
George Lodewijk Schorer	
Jan Willem Berkelbach van der Sprenkel	Gouda
Wim van de Woestijne	
Jan Spoelstra	
William Shakespeare	Stratford-upon-Avon
H.J.F.W. Brugmans	Laken
K. R. Gallas	Amsterdam
C.C. van de Graft	Tholen
A.G.A. van Rappard	Utrecht
Waldie van Eck	
K. Posthumus	
F.W.A. Korff	Amsterdam
M.J. Langeveld	Haarlem
Willy Dols	
C.F.A. van Dam	Amsterdam
A.C. Verbeek	
Leonhard Huizinga	Groningen
N.E.M. Pareau	Groningen
S.M. Noach	
H. Kraemer	Amsterdam
J. Patijn	
D.T. Spronk	
C.F. Meyer	Zürich
Ida Gerhardt	Gorinchem
Andreas Glotzbach	
A.H. Nijhoff	Den Haag
Henk Vastenouw	
G.H. Blanken	Varsseveld
Maurice Roelants	Gent
J.R. Evenhuis	
Christina Kroes-Ligtenberg	Bolsward
A.J. van Soest	
Koos Schuur	Veendam
E. Cantillon	Hoogvliet
Theo van Baaren	Utrecht
W. Wiersma	
A.J. Jansen	
Th.H.J. van Huet	
J. Buffin	
P.W.J. Steinz	
Hein de Bruin	IJlst
Elizabeth Barrett Browning	Durham
K. ter Laan	Slochteren
Horatius	
Elisabeth Cheixaou	Zweeloo
H.J. Pos	Amsterdam
H.J. van Tienhoven	
J.G. Delfgaauw	
G. Révész	Síofok
O. Bottema	Groningen
Daan Zonderland	Groningen
F. Lulofs	Den Haag
W.Ph. Coolhaas	Brielle
Jan Waterink	Nieuwleusen
A.A. Verdenius	Drachten
Jorge Manrique	
G. le Maire	Roosendaal
H.P. van den Aardweg	Hoorn
Jan Hendrik Jongkees	Bussum
Johanna K. Oudendijk	
Herman Johannes Lam	
H. Wagenvoort	
Willem van Reymerswael	
G.J.H. Kuyk	
Frank Onnen	Baarn
Leo Verdievel	Brugge
F. Ph. Groeneveld	
W.J.W. Koster	
W. Rip	
E. Horbach	
C.W. de Vries	
Jacobus Schuurmans Stekhoven	Leiden
Th.H. Lunsingh Scheurleer	
Eva E. Gerretsen	
G. Milius	
J.D.M. Cornelissen	Hertogenbosch
H. Engel	Koog a/d Zaan
Nel Veerman	
J. Hoogendoorn	
Alfred de Musset	Parijs
R. van Luttervelt	Haarlem
C.W. Sangster-Warnaars	
M.C. van der Werff	
Jan Klein	
E. Smedes	Assen
W. Gerdes	
J. Delden	
G.F.W. van Berckel	
F. Oudschans Dentz	Leeuwarden
August Henkels	
Abraham Schierbeek	Leeuwarden
Karel Jonckheere	Oostende
A.E. Rosendahl Huber	
Martin Permys	Amsterdam
Ph. Kohnstamm	Bonn
Johanna de Jongh	Kampen
J. de Kanter	
K.F. Proost	Geervliet
L. Aletrino	Amsterdam
T.P. Sevensma	Sneek
H. Gerversman	Sittard
J.M. Kramer	
Sergei Smirnov	
I.A. Bunin	Vorónezj
Dmitrij Sergeevic Merezjkovskij	Rusland
J.H. Thiel	Amsterdam
H.W. van Tricht	Arnhem
A. van Velsen	
Willem van Everdingen	
A.M. van der Giezen	Middelburg
Frouwien van der Vooren-Kuyper	
Herman Meyer	Amsterdam
K. Strijd	
J. Kruseman	
J.E. Verschaffelt	
Henk Breuker	Amsterdam
L.M.Fr. Daniëls	Nijmegen
G.H. 's- Gravesande	Buitenzorg (Java)
H.E. Enthoven	Amsterdam
W. Vloedgraven-Stuyver	
R.A.V. van Haersolte	
Michel van der Plas	Den Haag
Eduard Verkade	Amsterdam
Jan Gonda	
L. van den Ham	
M.C. Tideman	Rotterdam
Sjoerd Leiker	Drachten
W. Lubberink	De Wijk
J. Bax	
J.C.J. Kleijntjens	Maastricht
J.M. Sterken	
Lou Vleugelhof	Ovezande
Tue Gad	
S.A.M. Bottenheim	Amsterdam
R.F. Scheltema de Heere	Den Haag
Mies Bouhuys	Weesp
Willem den Boer	Dordrecht
L.C. Michels	Schijndel
J.R. Thorbecke	
L.W.G. Scholten	Amsterdam
Dirk Schoute	Deventer
Marinus van der Goes van Naters	
Bas van Gelder	IJsselmonde
A. Bicker Caarten	Elburg
P.J. Enk	Nijmegen
H. van de Waal	Rotterdam
M. van der Plas	
P. Krug	
Johannes van Melle	Goes
Nicholas G. Lély	
Jan C. M. Leijten	Etten-Leur
J.A. Bierens de Haan	Haarlem
Amoene van Haersolte	Utrecht
A.M. Chamalaun	
J.L.F. van Essen	Arnhem
Th.C. van Stockum	Dordrecht
Léon Polak	Rotterdam
Carl Mennicke	Elberfeld
Henri Overhoff	Bergen op Zoom
M. de Vroede	Mechelen
A.V.N. van Woerden	
Johan Tersteeg	Den Haag
B.L. van der Waerden	
A.G.M. van Melsen	
Fanny de Jong	
Karel Kuypers	
Paul A.G. Dibon	Romorantin (Loir & Cher)
Manuel van Loggem	Amsterdam
Jaap Romijn	Utrecht
Alb. de la Court	Leiden
Julien Benda	Parijs
Nico Verhoeven	Vught
Wouter Nijhoff	Den Haag
Th.M. Metz	
Henriëtte Schuurbeque Boeye	Zeist
Hanny Michaelis	Amsterdam
Carel Swinkels	Amsterdam
C. Buddingh'	Dordrecht
L.Th. Lehmann	Rotterdam
J.E. Jonkers	
J. van IJzeren	
C.H. Telders	Den Haag
J. Milius	
W.L.M.E. van Leeuwen	Amsterdam
T.S. Eliot	Missouri
Charles B. Timmer	Amsterdam
M. Klaassen	
Dj. Adinegoro	Talawi, Sawahlunto
Bertus van Lier	Utrecht
F.W. Zeylmans van Emmichoven	Helmond
Hans Bendien	
John Vandenbergh	
Truman Capote	Verenigde Staten
Edward Arlington Robinson	Verenigde Staten
Carl Sandburg	Verenigde Staten
Jan G. Elburg	Wemeldinge
Ezra Pound	Verenigde Staten
Horace Gregory	Milwaukee, Wisconsin
Charles-Henry Ford	Hazlehurst
Kenneth Patchen	Verenigde Staten
Thomas McGrath	Sheldon (North Dakota)
Gerrit Kouwenaar	Amsterdam
Robert Hayden	
Zack Gilbert	
Annetje Reens-Neufeld	
Frederick Franck	Maastricht
Casper Höweler	
E.G. Marshall	Owatonna
Anna Blaman	Rotterdam
Jan Spierdijk	Amsterdam
Jan Lincklaan Westenberg	Zutphen
Hendr. Ad. Warmelink	Deventer
Mea Verwey	Noordwijk aan Zee
Harry Brander	
Laurens Welagen	
Barend Rijdes	Neerbosch
G.J. de Vries	Haastrecht
Maurits de Meyer	Elversele
Nes Tergast	Salatiga (Java)
Jan Sebastian Rabie	
Ernst Denny Hirsch Ballin	
Dola de Jong	Arnhem
Dolf Verspoor	Den Haag
Rivai Apin	
W. Nienaber-Luitingh	Amsterdam
A.C.M. Kurpershoek-Scherft	Den Haag
D.G. van Vreumingen	
J.V. Rijpperda Wierdsma	Nijmegen
Hans Lodeizen	Naarden
Simon Vinkenoog	Amsterdam
Lucebert	Amsterdam
Gerard Diels	Amsterdam
Theo J. van der Wal	Maastricht
Josine Reuling	Amsterdam
H.E. Greve	Ambarawa
Christine D'haen	Sint-Amandsberg, Gent
W.J. van der Molen	Broek op Langendijk
Tom Eekman	Middelharnis
N.E.H. van Esveld	
G.J. van der Woude	
Carlo (graaf) Sforza	Montignoso di Lunigiana
Giacomo Leopardi	
A.H. Luijdjens	
Enrico Nencioni	Florence
Gabriele d' Annunzio	Pescara
Goffredo Bellonci	
Vitaliano Brancati	Pachino
Antonio Baldini	Rome
Bruno Zevi	
Umberto Saba	Trieste
Giulio Carlo Argan	
Corrado Govoni	
Lionello Venturi	
Eugenio Montale	Genua
Mario Verdone	
Massimo Mila	
Emilio Lavagnino	Rome
Hugo Claus	Brugge
Fred Polak	
David Scheinert	Czestochowa
H. de la Fontaine Verwey	Hilversum
J.G. van der Ploeg	Rotterdam
A. Kessen	Maastricht
J.Th. Spaan	
Charles Baudelaire	Parijs
Barend de Goede	
Maria Dermoût	Pekalongan (Java)
H.W.J. Kroes	Zwolle
J.A. Rispens	Noordwijk aan Zee
W.A.F. Stokhuyzen	
H.I. Keus	
Marius Wilhelm Holtrop	
W.R. Heere	Amersfoort
J.P. van Praag	
H.C. van de Hulst	
Sj. Groenman	
A.D. de Groot	Santpoort
Jan Peters	
C.A.R. Graamans	
J.J. Vriend	Gorinchem
Charles Wentinck	
W. Drees	Amsterdam
Leo van Egeraat	Langeweg
G.J. de Grooth	
A. van Lennep	
Remco Campert	Den Haag
Jan de Jong	
D.Th. Enklaar	Utrecht
J.H.J. van der Pot	Roosendaal
Maps Valk	
H. Wielek	Keulen
A.A.M. Horsting-Boerma	Veendam
William Faulkner	
Ch.G. Matser	Arnhem
W.J. de Haas	Amsterdam
H.B.G. Casimir	Den Haag
J.E. de Vos van Steenwijk	Zwolle
A.J. Kluyver	Breda
P.O.F.M. Cremers	Arnhem
W.A. Braasem	Soerabaja
Justus Meyer	
Cola Debrot	Kralendijk
W.Gs Hellinga	Haarlem
Guillaume van der Graft	Rotterdam
Hendrik Jan Reinink	Groningen
K.H.R. de Josselin de Jong	Den Haag
Ad den Besten	Utrecht
Pier Westra	
M.J. Francken	
Charles Webster	
Ernest Barker	
William A. Robson	
Oscar R. Hobson	
William Wilson	
Thomas Hardy	
Dylan Thomas	Swansea
Max Schuchart	Rotterdam
Doris Lessing	Kermanshah
Reyner Banham	
Robert Melville	
Marius Flothuis	Amsterdam
C. Nicolaï	
Charles Boost	Breda
F. Bender	Amsterdam
H.H.J. de Leeuwe	Essen
Leo Herberghs	Heerlen
A.C. Niemeyer	
J. Petri	
Herman van den Bergh	Amsterdam
Henri Wiessing	Vlissingen
David Koning	Amsterdam
Adriaan van der Veen	Venray
Harriët Laurey	Eindhoven
J.H. Kernkamp	Utrecht
G.H.M. van Huet	Rotterdam
Alfred Kossmann	Leiden
Anton Kloppers	Semarang
Arthur Lehning	Utrecht
J.G. de Beus	
A. Graafhuis	
Jan Wit	Nijmegen
A. Alberts	Haarlem
Bernard Vlekke	Oud en Nieuw Gastel
W.H. Somermeyer	
L.P.J. Braat	Arnhem
Josepha Mendels	Groningen
Jan Vermeulen	Leiden
B.W. Schaper	Voorburg
Yge Foppema	Dedemsvaart
Jacques den Haan	Rotterdam
C. Vermeer	
J.J. Beljon	Schoten
Christiaan Terpstra	Den Helder
Michaël Deak	Alkmaar
J.B. Charles	Zwolle
Ido Keekstra	Groningen
Rie Cramer	Sukabumi
J.H. Plokker	Rotterdam
Nico Rost	Groningen
Bert Schierbeek	Glanerbrug
Marga Minco	Ginneken
Nico Wijnen	
Jan Meulenbelt	Amsterdam
Abel J. Herzberg	Amsterdam
E.A.A. Vermeer	
P.J. Arisz	
Maarten Mourik	Streefkerk
K. Lekkerkerker	Willeskop
Hafis	Iran
C. Bittremieux	Nieuwpoort
Adriaan Morriën	Velsen
Liane Bruylants	Berchem
J.H. Schouten	
Henk Romijn Meijer	Zwolle
M. Vasalis	Den Haag
J. Valentin	Den Haag
W.F. Dankbaar	Amsterdam
Evert Werkman	
Rein Blijstra	Harlingen
Reinder P. Meijer	Zwolle
Klaas Wiersma	
Elsa Frank	
Louis Saalborn	Rotterdam
Ary den Hertog	Den Haag
Ben Stroman	Rotterdam
B. Hunningher	Vlissingen
Jan Walravens	Anderlecht
W.P. Pos	Amsterdam
Luisa Treves	Amsterdam
E. Elias	Amsterdam
Wim Vesseur	
A. Pitlo	Arnhem
Luc Lutz	Delft
G.A.M. Eickholt	
Tjalie Robinson	Nijmegen
Léon de Greiff	
A. Teeuw	Gorinchem
C.L.W. Fock	Den Helder
Pieter S. Gerbrandy	Goënga
J.D. Meerwaldt	Amsterdam
Dirk Volker Nijland	
Max Croiset	Blaricum
M.H.J. Verjans	
Nel Noordzij	Rotterdam
G. Quispel	Rotterdam
Jan van Gelder	
Lies Wolters	
Bernhard prins der Nederlanden	Jena
Fernán Silva Valdés	Montevideo
J.A. van Praag	Amsterdam
Pablo Neruda	Parral
Ventura García Calderón	Parijs
José Gorostiza	Mexico
A. Methöfer	
Rufino Blanco Fombona	Venezuela
Joaquín E. Weiss y Sánchez	
Menotti del Picchia	São Paolo
Martha de Castro	
W.H. van Helsdingen	Ambon
A.I. Spits	
E.P.M. Tervooren	
A. Jonkers	
R.A.J. van Lier	Paramaribo
J. van de Walle	Den Haag
Henk Dennert	
W.J. Jansen	
Frans Debrabandere	Kuurne
E.H. Kossmann	Leiden
Piet Apol	Amsterdam
P.A.H. de Boer	Woubrugge
Th. Govaart	Leiden
J.M. de Jong	Leiden
Franz Hellens	Brussel
Marcel Coole	Kortrijk
Bert van Aerschot	Lier
Paul Snoek	Sint-Niklaas
Elisabeth Eybers	Klerksdorp
Willem Elsschot	Antwerpen
J. Bruyn	
Reindert Jacobsen	
E.M. Janssen Perio	
Ary Delen	Leuven
Gerrit-Hugo Pronk	
Aleida Gerarda Schot	Amsterdam
Willem van Elden	Den Haag
Antonio Machado	Spanje
Martin Adán	Peru
Manuel Bandeira	Recife
Augusto Roa Bastos	Iturbe
Carlos Drummond de Andrade	Itabira
Cecília Meireles	Rio de Janeiro
José-Maria de Heredia	La Fortuna
Jules Supervielle	Montevideo
Erik Lindegren	Luleå
Amy van Marken	Hilversum
Sybren Polet	Kampen
Gunnar Ekelöf	
Artur Lundkvist	Oderljunga
Edith Södergran	Raivola
August von Platen	
Attila József	
Sándor Weöres	
David Rokeah	
Pham Van Ky	
Makhali-Phal	Phnom Penh
Pierre Brachin	
Waring Cuney	
Leslie M. Collins	
Owen Dodson	
Don Maquis	
Charles Causley	Launceston
S.A. Bonebakker	Varsseveld
Ed. de Jonghe	
Pieter Lieftinck	
J. Prins	
Egbert Krispyn	Haarlem
Dick Voerman	
Li Tai Po	
Gerrit Borgers	Brummen
Cenne de la Chitarra	Arezzo
G.J. Resink	Yogyakarta
B.M. Baxter	
Chr.J. van Geel	Amsterdam
Heere Heeresma	Amsterdam
Beb Vuyk	Rotterdam
J.L. Heldring	Amsterdam
W. Banning	Makkum
Henri Schadee	
L.G. Kortenhorst	
P.M. Boer-den Hoed	Leiden
L.J. Hartog	
Fred Pfeifer	Rotterdam
Theo Joekes	Den Haag
Victor Varangot	
S.F. Witstein	Rotterdam
Ton van Oudwijk	Utrecht
Wilfred Smit	Soerabaja
Saskia Ferwerda	Renkum
Catharina Kortebos	Amsterdam
Th.G. Sinnige	
J.G.M. Moormann	Goor
Catharina van der Linden	Schiedam
Walter Debrock	Oostende
B.H.D. Hermesdorf	Chevremont
H. Bianchi	Rotterdam
C.J.E. Dinaux	Ommen
Victor Spoor	
C.P. Gunning	
Corly Verlooghen	Paramaribo
Louise van Santen	Amsterdam
Roger Pieters	Halle
F. van der Blij	Leiden
S. Carmiggelt	Den Haag
Claude Korban	Beveren
C.J. Greshoff	
A. Middeldorp	Scherpenzeel
Fokke Sierksma	Dantumawoude
Jaap Harten	Blaricum
Mia van der Haegen	
Marcel Leemans	
Marcel van de Velde	Brugge
Lode de Visscher	Wetteren
C.O. Jellema	Groningen
B. Nieskens-Isphording	
Ivo Schöffer	Amsterdam
Willem Brakman	Den Haag
G.W. Ovink	Leiden
Wim Hijmans	Groningen
P. Gros	
J.I.S. Zonneveld	Kampen
Eddy de Vries	
Paul R. Rijkens	Amsterdam
A. Schaafsma	
B.J. van Eyk	Amsterdam
J.M.J. Kooy	Rotterdam
H.F. van Panhuys	
Maarten Rooij	Rotterdam
H. Nieuwenhuis	
J. Kassies	
Hella S. Haasse	Batavia
Arie Querido	
J. Droogleever Fortuyn	Rotterdam
M. Gruber	Dresden
Nol Gregoor	Den Haag
H.W.F. Stellwag	Groede
Sigmund Freud	Freiberg
H.P.H. Jansen	Amsterdam
H. van Riessen	Bloemendaal
Henri Sandberg	Batavia
Jan Wolkers	Oegstgeest
Max Nord	Gorinchem
K. Schippers	Amsterdam
Jacques Hamelink	Driewegen (bij Terneuzen)
B.V.A. Röling	
C.A. Zaalberg	Arnhem
A.J. Dekker	
M.D. Ozinga	Pernis
Karel De Clerck	Etterbeek
Willem van Toorn	Amsterdam
Lizzy Sara May	Amsterdam (Sloten)
François Meyer	
H.A. Combé	
Marcus de Jong	
Tj.S. Visser	Amsterdam
G.A. van Poelje	Naaldwijk
R.A. Cornets de Groot	Bandoeng
H. Leffelaar	
Paul Rodenko	Den Haag
Jan Aler	
Martin J. Klein	
Burny Every	Aruba
Bernardo Ashetu	Kasabaholo
E. Eijkemans	
Han Lammers	
Marko Fondse	Haarlem
Ger Harmsen	
L.H. Janssen	Maastricht
Hans Sleutelaar	Rotterdam
Jakobus Kloek	
F.E. Frenkel	
Leo Ross	Zwartsluis
Ewald Vanvugt	's-Hertogenbosch
C.B. Vaandrager	Rotterdam
K. Rijsdorp	
P. Hummelen	
G. Puchinger	Amsterdam
H. van der Linde	
Albert Besnard	Den Haag
W. Boswinkel	Amsterdam
J. Brugman	
Floris Evers	
Hendrik van Teylingen	Haarlem
W. Gortzak	Amsterdam
Carl Friedrich von Weizsäcker	
Jan Hanlo	Bandoeng
James Brockway	Birmingham
O.M. de Vaal	Rotterdam
David Maarschalk	Den Haag
Joris Diels	
Bertram Joseph	
Ben Jonson	
John Milton	
N. Brugman-Begemann	
Samuel Johnson	
Erik Vos	Hellendoorn
Coenraad van Emde Boas	Rotterdam
Neeltje Maria Min	Bergen
J.A.G. Tans	Maastricht
H.C.J. Duijker	Leiden
Ton Lathouwers	
A.M. Meerloo	
Huug Kaleis	
D.U. Stikker	Winschoten
S.C. Derksen	
S.R. de Groot	
H.J.A. Hofland	Rotterdam
Frits Kief	
Nico Scheepmaker	Amsterdam
Abram de Swaan	
Henk Sneevliet	Rotterdam
Wim Klinkenberg	
Sem Davids	Amsterdam
J.W. Holsbergen	Rotterdam
Henk van Kerkwijk	Amsterdam
Bob den Uyl	Rotterdam
Herman Gorter	Wormerveer
Helen Knopper	Naarden
H.M. Voetelink	
Michaël Slory	Totness
R. Roegholt	Semarang
Peter van Lieshout	Hertogenbosch
Peter Schat	
J.H. Donner	Den Haag
G.A.C. Hubers	
Wim Zaal	
Mark Insingel	Lier
Eldert Willems	Schaarbeek
Rommert Boonstra	Groningen
Willem Frederik Hermans	Amsterdam
Harry Mesterom	
Marianne Meester	
Sonja Prins	Haarlem
J.H. Mak	
Martin Hartkamp	Amsterdam
H.C. ten Berge	Alkmaar
Henry Faas	Amsterdam
Benno J. Stokvis	
Frank Diamand	
Arnold de Vos	
Paul Steenhauer	
Hans Vlek	Amsterdam
Cees de Jong	
H.A. Gomperts	Amsterdam
A.J. Westerman Holstijn	
Joop den Uyl	Hilversum
J. Sperna Weiland	Zwollerkerspel
J.W. Hingst	Bergum
Henriette van Duin	
Alette Beaujon	Curaçao
Simon Koster	Rotterdam
Judith Herzberg	Amsterdam
Frits Dekking	Rotterdam
Milo Anstadt	Lwów
Ferenc Karinthy	Boedapest
Bart Tromp	Sneek
Wim van Rees	
Misha Mengelberg	Kiev
L.H.C. Hulsman	
Jan J. Klant	Warmenhuizen
Dick Hillenius	Amsterdam
Teo Anton van Kooten	
Bas van de Werk	
Aad van der Mijn	
Fenna van den Burg	Apeldoorn
Paul van 't Veer	
Jan Rogier	
L.H. Wiener	Amsterdam
Johan T. van Minnen	Noordwolde
Arend Heyting	Amsterdam
G.M.N. Verschuuren	
A.J. Cuppen	
Johan Jansen	
Huib Riethof	
David Kettler	
Kees Ouwens	Zeist
Nic Brink	
Theo de Boer	Zuid-Beijerland
K. Zickhardt	
Riekus Waskowsky	Rotterdam
Hans Gruyters	Helmond
Henri van Praag	Amsterdam
C.J. Dippel	
Hein Ruygers	
H. Linnemann	
M.G. Plattel	
Aad Nuis	Sliedrecht
Monika Warnenska	
Thierry de Beaucé	Lyon
Enno Endt	Enschede
Jan van Harten	
Jan van der Vegt	Scheveningen
Abraham Sutzkever	
Kees Simhoffer	Den Haag
Ben Wolken	Nijmegen
H. Ramaer	
Peter Weibel	Polen
Bea Vianen	Paramaribo
E. Land	
R.A. Maandag	
E.M. Barth	Strinda
J.S. Henriksson	Leeuwarden
Tiele Rümke	
Herma Vergouwe	
Rutger Kopland	Goor
Arnold Spauwen	Maastricht
Aryiris Chionis	
H.M. Ruitenbeek	
M.C. Brands	Haarlemmermeer
A.G. van der Spek	
H. Schaafsma	
H. Daudt	Amsterdam
Johan Goudsblom	Bergen
Loden Vogel	Amsterdam
L.J. Zimmerman	Amsterdam
Jos Ruting	Amsterdam
Klaus Siegel	Düsseldorf
Wilna Burger	Rijswijk
Luk Wenseleers	
Theo Stibbe	
J. van der Gaag	Utrecht
Nicolás Guillén	Carmaguey
Jacques Vallier	
Lucas van der Land	Amsterdam
Alejo Carpentier	
Constance E. van der Maesen	
Heberto Padilla	
R.J.A. van Suchtelen van de Haere	
Louis Ferron	Leiden
A.L.R. Fernhout	
Bastiaan Willink	
Hans Knoop	
Thera Coppens	Amsterdam
Wiek Röling	
Huub Oosterhuis	Amsterdam
Wessel te Gussinklo	Utrecht
Tom van Deel	Apeldoorn
Gerard Termorshuizen	
Hans van de Waarsenburg	Helmond
Jules Dister	
Frans Brüggen	Amsterdam
T.M.T. Coolen	Berlijn
Astère Michel Dhondt	Mechelen
Wim Rouw	
Jane Debrot	
Pieter A.M. Seuren	
S.C. Dik	Delden
A. van Dantzig	Gouda
Hendrik Conscience	Antwerpen
Peter Collier	
Orlando Emanuels	Paramaribo
Roel van Duyn	Den Haag
Oscar Timmers	Heerlen
Ho Chi Minh	Vietnam
Konrad Boehmer	Berlijn
Hans Keller	Haarlem
Vasilis Vasilikos	
Kenneth Keniston	
L.L. Coïni	
Gerrit Bakker	Alkmaar
Leo Haring	
Jan Geurt Gaarlandt	Rotterdam
Jacques L. Schmitz	
Robert Paul Flipse	Amsterdam
Louis Andriessen	
Lieuwe Brouwers	
César Vallejo	Santiago de Chuco
Oswaldo Salazar	
Karen Spalding	
Percy B. Lehning	
J.F. Glastra van Loon	Batavia
Bertus Dijk	
Nicanor Parra	
Walter Haesaert	Merendree
Reinjan Mulder	Geldermalsen
Kees Fens	Amsterdam
F. Tichelman	Madioen, Java
J.D. van der Meulen	
Judicus Verstegen	Den Helder
António Jacinto	
Godfried Bomans	Den Haag
Charles Bettelheim	Parijs
Johanna Fortuin	
Willem van Malsen	Utrecht
Mark Brusse	Alkmaar
Klaas de Jonge	
Aart J.M. van de Laar	
Go Mandersloot	
W.G. Wolters	
D. van Arkel	
E. Mandel	
Mary McCarthy	
Hans Tentije	Beverwijk
H.G. Matthes	
G.A. Lindeboom	
Silvia W. de Groot	
R. Dobru	Paramaribo
Rodney Russell	Paramaribo
Ch.J. Wooding	Paramaribo
Judith Allard-de Kom	Den Haag
H.F. de Ziel	Paramaribo
Pieter Polanen	Paramaribo
Shrinivási	Kwatta, Beneden-Suriname
A.F. May	
Jo Löffel	Nieuw-Nickerie
Thea Doelwijt	Den Helder
Paul Marlee	Paramaribo
Jozef Slagveer	Totness
Edgar Cairo	Paramaribo
R. de Jong	
Gerrit Huizer	
Michael Wilson	Kaapstad
Wim Huyskens	
Wouter Donath Tieges	Amsterdam
F.A. Snellaert	Kortrijk
G.P.F. Buddingh'	Waalwijk
Norbert Elias	Wroclaw
Anton Korteweg	Zevenbergen
Hugo Brandt Corstius	Eindhoven
P.Th. Hugenholtz	Amsterdam
P.A. Verburg	
Ans van Haersolte	Arnhem
Lodewijk Prins	
Ed. Ebels	
Anneke Jansen	
R. Sierksma	
Reinbert de Leeuw	
Kees Winkler	Hoorn
Cyrille Offermans	Geleen
Rob Vermeulen	
Wijnand Steemers	
Dirk Kroon	Schiedam
Geert Evert Booij	Hoogeveen
Theo de Jong	Haarlem
Reinout Bakker	Minnertsga
A. Ladan	
C. van de Haar	
H.J. Vieu-Kuik	
H. de Lange	
O.J. de Jong	Culemborg
H.F.J.M. van den Eerenbeemt	Roosendaal
W.M. Zappey	
Rob Rentenaar	
W. Burger	
Peter Harper	Groot-Brittannië (en Noord-Ierland)
Ivan Illich	Wenen
C. Schepel	
John H. Schaar	
Bart van Steenbergen	
Bram van der Lek	
J.J.G. Syatauw	Bandung
A. van 't Laar	
J.Th.M. Palstra	
Hugh P. Gallacher	
C.J. Stigter	
J. Hetterschij	
H.H. ter Balkt	Enschede
H.M.A. Struyker Boudier	
Fred Bornstein	
Bouke B. Jagt	Padang
Fons Elders	
Peter Berger	Abcoude
A.L. Vos	Amsterdam
Friedhelm Debus	Oberdieten
Mischa de Vreede	Batavia
Camiel Hamans	
Dolph Kohnstamm	Amsterdam
J.R. Slotemaker de Bruine	Sliedrecht
Matthijs Siegenbeek	Amsterdam
H. Baudet	Den Haag
C.D. Saal	
S.J. Doorman	Den Haag
J.M.W. van Ussel	
J. van Baal	Scheveningen
E.V.W. Vercruijsse	
Jan Donkers	Amsterdam
Adam Szirmai	Boedapest
Eddy van Vliet	Antwerpen
H.J. Verkuyl	
Raymond ten Berge	
Jan W.H. Wentink	
W.E. Krul	
Marianne Vos	
Rob Bognár	
Berend Lasseur	
Derek Phillips	
M.C.A. Brongers	
Paul Goodman	Verenigde Staten
Sorin Alexandrescu	Boekarest
Adrian Pâunescu	
Jacques van Alphen	
Ad Kooyman	
Peter Hofstede	
J.Th. Snijders	
Tessel Pollmann	
Hermann H. Frese	
Alvin W. Gouldner	New York City
Hidde van der Ploed	
P. Schumacher	
Hessel Miedema	Sneek
Julio Cortázar	
E. van der Starre	Rotterdam
Armando	Amsterdam
Jacob Groot	Venhuizen
Samuel de Lange	
Eva Vondeling	
Józef Lewandowski	
Annie Gransch	
Nadjezjda Mandelstam	
I.F. Fedorov	
Bessie Schadee	
Joeri Galanskov	Moskou
Esselien 't Hart	Wageningen
Aleksander Ivanov	
Michail Kalik	
Vikentij Gerasimtsjoek	
Adam Tern	
Jos J.B. van der Putten	
Franco Ferrarotti	Palazzolo Vercellese
Alexander Münninghoff	
Guy Desrole	
Els de Graaf	
A.P. van Goudoever	
Michel Korzec	Lodz
Nico Wilterdink	
Han de Vries	Amsterdam
Laurens van Krevelen	
Gerbrand Muller	Leiden
Ruud A.J. Kraaijeveld	Alblasserdam
Hugues C. Pernath	Borgerhout
Willy Lauwens	
C.W. Aakster	
A.J. Dunning	Arnhem
Hilbert Kuik	Amsterdam
P. Hirschler	
Chris Mast	
C.J.B.J. Trimbos	Vught
G.A. Ladee	
J.H. de Haas	Middelharnis
R.A. Basart	Amsterdam
Marcel van der Linden	
Bert Menco	
Tim Krabbé	Amsterdam
Willem M. Roggeman	Brussel
Noam Chomsky	Philadelphia
Robert S. Cohen	New York
José Cardoso Pires	Portugal
August Willemsen	Amsterdam
Hans Faverey	Paramaribo
Anton Haakman	Bussum
Francisco Marinho	
Jan Stroop	
Hans Plomp	Amsterdam
Gerben Hellinga	Samedan
Antal Sivirsky	Boedapest
Maarten 't Hart	Maassluis
Boris Tomas	
E.C.P. van Waalwijk van Doorn	
H.R. van Gunsteren	
J.H. Kamstra	Arnhem
Anton Blok	Amsterdam
Esteban López	Etterbeek
Peter Zonderland	
Cor Blok	Den Haag
Lidy van Marissing	Bussum
H.E. Ruitenberg	
Jak van der Meulen	
Jean Améry	Wenen
P.R. Baehr	Amsterdam
Martin Mooij	Rotterdam
Hans Carl Artmann	Wenen
Elisaveta Bagrjana	
Keorapetse Kgositsile	Johannesburg
Michael Krüger	Wittgendorf
Philip Levine	
Czeslaw Milosz	Szetejnie
János Pilinszky	
Waldo Rojas	Concepcion
Sapardi Djoko Damono	Solo
Mongane Wally Serote	Sophiatown
Charles Tomlinson	Stoke-on-Trent, Staffordshire
Kazuko Shiraisi	
Raymond Benders	
Martin Lusse	
Ruud Löbler	
P.A. Wackie Eysten	
Daniel de Lange	
Gust Gils	Antwerpen
V.S. Naipaul	Chaguanas
George Huppert	
Breyten Breytenbach	Bonnievale
Adriaan van Dis	Bergen
Charles Vergeer	
Hans van den Bergh	Amsterdam
Paul Kapteyn	Schagen
F.B. Hotz	Leiden
Pier Boorsma	Sneek
Jack ter Heide	
Grahame Lock	
Ton Korver	
M. Fennema	Leeuwarden
Margriet Poort	
Elmer Schönberger	
Jules A. Deelder	Rotterdam
Christine Brinkgreve	Amsterdam
Alex Korzec	Lodz
J.J. Witkam	
Siep Stuurman	
Emil Bentzen	
Arie Gelderblom	Nieuw-Lekkerland
Maria van der Moer	
Peter Nijmeijer	Amsterdam
Paul Celan	Czernowitz
J.W. Niemeijer	Sneek
Jaime Mendizábal	
Frans de Rover	Rotterdam
Magda van Emde Boas	Praag
Stefan Morawski	
Sjoerd Kuyper	Amsterdam
Hans van Lier	
F.G. Droste	Arnhem
Pieter de Meijer	
Alex van Gelder	
Fernando Schellen	
A.K. Koekkoek	Willemstad
C.J.M. Schuyt	Leidschendam
Cees Cruson	
Philip Ramp	Holland, Michigan
John Berger	
Loek Esmeijer	
Arthur Mitzman	Newark, New Jersey
B.J.S. Hoetjes	
Petrus Adrianus Johannes Bentvelzen	
J.J. van der Werff ten Bosch	Rotterdam
M.B. ter Borg	Groningen
Louis Boon	
August Heyting	
Hans Magnus Enzensberger	Kaufbeuren
Leo Damen	
R.Th.R. Wentges	
Ampie Coetzee	
Gérard van den Eerenbeemt	Venlo
Leo Fretz	
W. van Dort	
Marcel Baudet	
Godert van Colmjon	Amersfoort
Walter van der Star	
Dick Pels	
R.H.J. Egeter van Kuyk	Jakarta
Lloyd Haft	Wisconsin
H.J. Smeding	
Patrick Conrad	Antwerpen
Marcel van Maele	Brugge
Hugo Raes	Antwerpen
Toon Tellegen	Brielle
E.J. Dommering	Amsterdam
Leendert Witvliet	Werkendam
Th.J. de Jong	
Joyce van Lankeren	
J.N. Swallow	
Margreet Hirs	
Erika Dedinszky	Hongarije
W. van Drimmelen	Delft
Botto van den Bergh	Den Haag
Carlo Ginzburg	Turijn
Peter van Gestel	Amsterdam
Freek Bruinsma	
I. van der Sluis	
J.J. Klinkert	
F. Vos	
Akira Nagazumi	
Rudy Kousbroek	Pematang Siantar (Sumatra)
Ango Sakaguchi	
Jan Noordhoek	
E.G. de Poorter	
M.J. de Meijer	
Wim Markus	
Jaap Oostermann	
J.H. van Geemert	
Pieter Spierenburg	
Jacques Kruithof	Rotterdam
J.M.A. Biesheuvel	Schiedam
Pieter Lukkenaer	
Lela Zeckovic	Varazdin
Ben Cami	Durham
José Boyens	
A.H.G. Rinnooy Kan	
Marcel van Herpen	
H.T. Boonstra	
A.J. Kox	
Constantijn Huygens	Den Haag
Ph. de Vries	
H.J.M. Bos	
J. Lodewijks	
Dick van den Bosch	
Emma Brunt	
J.W. Bezemer	Pijnacker
Martin Veltman	Leeuwarden
John Kleinen	
Edzard Dideric	
Remco Ekkers	Bergen
Alfred Pijpers	
J. Popken	
Michael Masuch	Berlijn
Frida Balk-Smit Duyzentkunst	Amsterdam
Ida van Heteren	
J.M. van der Horst	Leiden
Elly de Waard	Bergen
Frans H. van Eemeren	
J.H. Maureau	
Ad Teulings	
Frans de Cort	Antwerpen
G. Dijkink	
J. Beijk	Haarlem
Tsjow Meng-Tiè	
Erik K. de Vries	
L.C. Suttorp	Schiedam
Willem Bijsterbosch	Hertogenbosch
Hans Verhagen	Vlissingen
G.J.H. van Gelder	
Sadiq Galal al'Azm	
A.H. de Groot	
R. Kruk	
G.H.A. Juynboll	Leiden
J.J.G. Jansen	Amsterdam
Usama ibn Munqidh	
C.A.O. van Nieuwenhuijze	
Roel Otten	
C.G. Brouwer	
F. de Jong	
P.S. van Koningsveld	
L.I. Graf	
R.J. Spruit	
Octavio Paz	
Steef Davidson	Amsterdam
Isaak Kaplanas	St. Petersburg
R. Kroes	
Anthony Mertens	Eindhoven
W.A.M. de Moor	Zevenaar
Rabin Gangadin	Paramaribo
Jan Siebelink	Velp
Aleid Truijens	
Jérôme Vervaecke	
Klaas Ruitenbeek	
Lu Xun	
Cita Golterman-van Dijk	Den Haag
Peter Reinhart Gleichmann	
Albert Jan Govers	
Herman Roodenburg	
E.E.G. Vermeulen	
Philippe Noble	Le Puy
Pim den Boer	
Margot de Hartog	
Michel Huisman	
Frans W. Saris	
R. Vanderauwera	
Maarten van Rossem	
Jacobus Bos	Rotterdam
Henk Tromp	
M.J. Weggelaar	
K. van der Arren	Buenos Aires
Lea Dasberg	Amsterdam
Carolijn Visser	Leiden
Rob Delvigne	Amsterdam
J.E. Ellemers	Soerabaja
E. van den Boogaart	
Dhiravat na Pomberja	
Maria Bogucka	
Han ten Brummelhuis	
Hendrik Henrichs	
Louis Emmerij	Rotterdam
A.B. Lapian	
Willem Otterspeer	Ouderkerk aan den IJsel
A.M.J. de Keijser	
Peter van Seters	
R. Lindeman	
M.K. van der Steeg	
Arie Rip	
Berend Lantink	
Gunther S. Stent	Berlijn
Nelleke van Maaren	Beverwijk
W.A. Verloren van Themaat	
Manuel Kneepkens	Heerlen
Jeroen Henneman	Haarlem
Rien Goettsch	
Nel Veenboer	
Beate Zilversmidt	
A.J. van der Staay	
Ilja Scholten	
Jan W. Boersma	
L.P.J. Veelenturf	
J.D. Querido	
Herman de Lange	
Herman Franke	Groningen
Jean-Paul Franssens	Groningen
G.L. Durlacher	Baden-Baden
Herbert van Erkelens	Alkmaar
Ron Hey	
F.L. van Holthoon	
Wim Neetens	
Paul Casparie	
Helga Nowotny	
Rien van den Broek	
Jan Paul Hinrichs	
C.W. Mönnich	
W. Albeda	Rotterdam
Hans van de Braak	
Kees Nijland	
P. Smoor	
Lourina de Voogd	
Ed de Moor	
Frank Loog	
Hans Berghuis	Apeldoorn
Henk de Velde	
Eva van Sonderen	
Willem G. Weststeijn	
P.J. de Voogd	
G. Groenhuis	Utrecht
Hans Ester	Utrecht
Marjan Groenewegen	
A.C. Zijderveld	Malang
Frans Budé	Maastricht
Douwe Draaisma	Nijverdal
Frans Weitenberg	
Peter Zeeman	
Kees Caljé	
Reinold Widemann	
Jaap Goudsmit	
Marijke Rijsberman	
Hans Bertens	
Jaap van der Bent	
Rik Planting	
R. Overeem	
Tonja van Rijthoven	
Jaap van Heerden	
Maarten Steenmeijer	
Jan Houwink	Sneek
Pieter Sijpersma	
Otto van den Muijzenberg	
Nico G. Schulte Nordholt	
R. Menggali	
Elly Touwen-Bouwsma	
Henk Schulte Nordholt	
H.M.J. Maier	
Wil Rouleaux	
Ulrike Weinhold	
Ben de Pater	
Marie-José Heijkant	
Tjalling Bos	
Leander Hanssen	
Raymond Corbey	Susteren
Joris Iven	Diepenbeek
Adriaan M. van der Hoeven	
Vojtech Mastny	
A. Lammers	
Jan Bank	Amsterdam
Herman de Liagre Böhl	
Jan Blokker	Amsterdam
A.C.M. de Kok	
Elsbeth Etty	Hulshorst
Marga Demmers	
Carme Riera	
Bob de Nijs	
Xavier Fàbregas	
Siem Juliard	
Paul van Heck	
Dirk van Bastelaere	Sint-Niklaas
Th. Kuiper-Weijhenke	
Eva Hofman	
P.F.M. Fontaine	Amsterdam
W.L. Stokvis	Vianen
Evert Sweens	
Freddy de Vree	Antwerpen
Gerrit Krol	Groningen
Carl Friedman	Eindhoven
Rolf Wolfswinkel	Amsterdam
Wim Reilingh	
Hub. Hermans	
Jan Lechner	
H.J. 't Hart	
André Spoor	Den Haag
Hans Freudenthal	Luckenwalde
Hans Ree	
S.V. Langeveld	
Jan Tinbergen	Den Haag
Beatrijs Ritsema	Tunis
Louis J. Mostertman	
J.P. de Jong	
Jojada Verrips	Schoonrewoerd
H. Schuttevâer	
L. Lafour	
Gerhard Dünnhaupt	
Jan Kuijper	Amsterdam
C.J.G. Holtzappel	
Hans Ras	Rotterdam
Henk Flinterman	
Johan B.W. Polak	
Rob Sijmons	
Ph.M. Bosscher	Heiloo
Kitty Verrips-Roukens	
M.A. Wes	
Paula Vermeyden	Rotterdam
H.L. Wesseling	Den Haag
H.W. von der Dunk	Bonn
Frank Kuitenbrouwer	Utrecht
Flip de Kam	
Drs. P	Thun
K.L. Poll	Dordrecht
I. Samkalden	
José Rentes de Carvalho	Portugal
G. Leppers	Maastricht
Hans Dorrestijn	Ede
H.A.M. Snelders	
Pieter Lakeman	
G.M. van Asperen	Rotterdam
J.P. Guépin	Amsterdam
Hugh Jans	
Ch. Enschedé	Haarlem
Ellen Ombre	Paramaribo
Gerrit Komrij	Winterswijk
Jan van Hoften	
G.A. Wagner	
Frans Hüsken	Nijmegen
Wilt Idema	
B. de Gaay Fortman	
E.P. Wellenstein	Scheveningen
Jan Juffermans	
Frank Martinus Arion	Curaçao
J.C. Heesterman	
Hans Calis	
Herman Hertzberger	
Berthe Meijer	Amsterdam
A. Komen	
Charlotte Mutsaers	Utrecht
A.M. Hagen	
E. T. Woudstra	
Egil Törnqvist	Uppsala
Dédé Brouwer	
Bart Driessen	
Peter van der Veer	
Herman Tieken	
M.E. 't Hart	
Reinder Boverhuis	
Sanjukta Gupta	
William H. McNeill	Vancouver
Jan Lucassen	
Wout Ultee	
Fréderique van Cleeff-Hiegentlich	
Annemarie Cottaar	
Aart G. Broek	Maasland
Hugo Pos	Paramaribo
Igma van Putte-De Windt	Curaçao
Gregor Benton	
Gèr Boosten	Valkenburg
J. Weisgerber	Brussel
David Minter	
Terrence Doody	
Joris Duytschaever	Antwerpen
Harold Beaver	
Michel Bartosik	Antwerpen
K. Michel	Tilburg
Jan Peter Nauta	
Ton Ceelen	
Bram Kempers	
B.G.J. de Graaff	
J.C.H. Blom	Leiden
Kees Revier	
Han Foppe	Den Haag
Joke Dame	Amsterdam
Flora Stiemer	
H.G. van Bueren	Rotterdam
Thom Holterman	
Joke Huisman	
Marijke Smalbraak	
Edmund Licher	
Paul M. Doolan	Ierland
Jan H. Mysjkin	
Ben van Melick	Hoensbroek
Cok van der Voort	
Dick Molewijk	
B. Zwaal	
Marietta Ioannidou	
Hero Hokwerda	
Jan Klees	
Mario Molegraaf	
Andriëtte M. Stathi-Schoorel	
W.J. Aerts	Amsterdam
Salvador Hertog	Maastricht
Lodewijk Brunt	
Ton Naaijkens	
Jos van Asperen	
Jan Gielkens	
Paul Marijnis	Schiedam
André Brink	
J.H. van Dijk	
Guy Posson	
Elisabeth van Elsen	
Hans Aniba	Den Haag
Ben Sloot	
Hans Moll	
Herman Koningsveld	
Raymond van den Broeck	
Agnes M. Zwaneveld	
René van Hezewijk	
Philip van der Eijk	
Kitty M. van Leuven-Zwart	
Anneke Neijt	
Jenny Tuin	
Jos Perry	Maastricht
G. van Os	
Cees Koster	
B.J. Asscher	Haarlem
Dorie Nielen	
Helen Saelman	
Ines Colijn	
Anne Marie Heemskerk	
Daphne Muller	
Menno Kraan	
Miriam Van hee	Gent
Maarten van Buuren	Maassluis
Remieg Aerts	Amsterdam
Hubert Smeets	
Peter Odell	
Chun-chan Yeh	
Jean-Clarence Lambert	
Peter King	Wimbledon
Marc Galle	Denderleeuw
A.J. Goblet (d'Alviella)	Doornik
Hans Hom	
Sitor Situmorang	Harianboho
Robert P. Swierenga	
Jan Zielonka	
Monika van Paemel	Poesele
Jan Stavinoha	Praag
Ágnes Roboz	
Margret Brügmann	
Stephen Mennell	
Herman Liebaers	Tienen
Geoffrey Douglas Madge	
Monika Triest	Aalst
Ernest Zahn	
Jan Bakker	
Paul J.A. Frische	Roermond
Frans Kusters	Nijmegen
Boeli van Leeuwen	Curaçao
Nicolette Smabers	Den Haag
Jan Versteeg	
Gerrit-Jan Berendse	
Willem Derks	
Salvador Bloemgarten	Schaarbeek
H. Schippers	
H. Schröder	
F.G. von der Dunk	Bilthoven
J. van Tooren	
Ieme van der Poel	
Manet van Montfrans	
Henk Hillenaar	
Ruud Meijer	
Maria van Daalen	Voorburg
Hendr. Gerritsen	Zeeland
E.M. Beekman	Amsterdam
Jack Vance	San Francisco
John Heymans	
Michael O'Loughlin	
Jozef Deleu	Roeselare
Roland Mortier	Gent
Mark Schaevers	
Anne Marie Musschoot	Gent
Paul Claes	Leuven
Georges Adé	Antwerpen
Wim van Rooy	
Michel Oukhow	Ukkel
Herman Sabbe	Brugge
Geert Bekaert	Kortrijk
Nico Frijda	Amsterdam
C. Schmidt	
Evert van Uitert	Amsterdam
Marius Buning sr.	Zwijndrecht
L.K.H. van Beek	
Antoine Bodar	Hertogenbosch
Marja Brouwers	Bergen op Zoom
Louise O. Fresco	Meppel
Jan Kostwinder	Oude Pekela
Ron Elshout	Rotterdam
Kreek Daey Ouwens	Geleen
Mieke Tillema	
Laurens van Schie	
György Spiró	Boedapest
Dorin Tudoran	Roemenië
Jan Fontijn	Amsterdam
Rudi Wester	Leeuwarden
J.J. Oversteegen	Blaricum
Ian Gibson	
Arjen Duinker	Delft
J. Heymans	
Piet de Rooy	
Greetje van den Bergh	Tiel
P.H.J.T. Ververgaert	
Willem de Ruiter	
J.H. Brinks	Almelo
K. Kolthoff	
Henry Schogt	Amsterdam
Kristien Hemmerechts	Brussel
Miel Vanstreels	Godsheide (Hasselt)
Geert Maessen	
Barber van de Pol	
A.D. Leeman	
Theodor Duquesnoy	
Graa Boomsma	Nieuwe Niedorp
M.J. Trappenburg	
Patricia de Martelaere	Zottegem
Guido Eekhaut	Leuven
J.A.A. van Doorn	Maastricht
G.C. Molewijk	
C.J.F. Stuldreher	Oldenzaal
Liesbeth Dolk	Jakarta
Jero Gardenia	Groningen
Helena Spanjaard	
Lucas Reijnders	
Koos van Weringh	
Selma Leydesdorff	
Adriaan Venema	Heiloo
Oscar van Weerdenburg	
Wouter Gomperts	
Henk te Velde	
Frank Albers	
Rouke van der Hoek	Eindhoven
Joachim von der Thüsen	
J.W. Onderdelinden	
Paul van der Heijde	
Maarten Doorman	Meppel
Eelco Runia	
Job Creyghton	Terwinselen
Antoine A.R. de Kom	Den Haag
Riet de Jong-Goossens	
Karin van Lierop	
C.P. Bakker	
Joris Pintor	
Georgine Sanders	Padang
Jacq Firmin Vogelaar	Tilburg
Marc Schreurs	
Jan Timman	
H.H. Kubbinga	
Mark van Andel	
Lieneke Frerichs	
Mary G. Kemperink	
Anton van Wilderode	Moerbeke-Waas
Umberto Eco	
J. Mannoury	Wormerveer
Maarten van der Wee	
Niek Muller	
Ineke van Kessel	
A.L. Schneiders	Castricum
Car Flanders	Zottegem
Wina Born	Sliedrecht
Jan Mulder	Bellingwolde
G.L. van Lennep	
Yvonne Kroonenberg	Amsterdam
Cisca Dresselhuys	Leeuwarden
Ch.J. Enschedé	Amsterdam
Harry G.M. Prick	Roermond
Huib van Krimpen	
Gerardjan Rijnders	
Max van Rooy	
Hans Maarten van den Brink	Oegstgeest
Ben Bos	
Gerard de Vries	Leeuwarden
Walter van den Broeck	Olen
S.F. Baekers	Leiden
Agnes Verbiest	
Alex van Schooten	
Gie van den Berghe	Gent
Michiel Mastenbroek	
Th.M. Scholten	
Henk Harbers	
Jeroen Boomgaard	Breda
Andries Sarlemijn	
Michiel van Kempen	Oirschot
Guido van Heulendonk	Eeklo
Jeroen J.H. Dekker	
Jan Brands	
Joël Cahen	
Ernst van Alphen	
Ria van den Brandt	
Stephan Sanders	Haarlem
Hugo Verdaasdonk	Amsterdam
Christa Schuenke	
Thomas Rosenlöcher	Dresden
Christine Delhaye	
Rudi Laermans	
Geert van Beek	Gennep
Koen Dille	
Rik Lina	
Saskia Poldervaart	
Jan Bervoets	
Andries Querido	
W.S. Huberts	Utrecht
Lambert Lambertz	
Richard Todd	
Bert Wartena	
Kamiel Vanhole	Etterbeek
Marc Adang	
Tjebbe van Tijen	
Jean A. Schalekamp	Rotterdam
M.J.P.M. Weijtens	Eindhoven
Olga Krijtová	Hradec Králové
Zofia Klimaszewska	
René A. Römer	Willemstad
C.E. Dip	
Luc Alofs	
Alex Reinders	Schaesberg
Gladys do Rego-Kuster	Curaçao
Carel de Haseth	Curaçao
Jules de Palm	Curaçao
Henry Habibe	Aruba
Walter J.M. Palm	Curaçao
Elis Juliana	
Lasana M. Sekou	
Wim Rutgers	Dinxperlo
Jos de Roo	Bad Liebenzell
Frans Heiligers	
Robert A. Rojer	
Felix de Rooy	
Michael A. Newton	Curaçao
Roel J. den Dulk	
Emma Crébolder	Sint Jansteen
Yvonne Né	
Marc Groenhuijsen	
Leo Morpurgo	Paramaribo
Theo Para	
Peter Meel	
Nardo Aluman	
Frans Malajuwara	
Ruud Beeldsnijder	Amsterdam
Celestine Raalte	
Carlo Hoop	
Dorus Vrede	Lombe
André Pakosie	Diitabiki
Surianto	Plantage Johannesburg
G.D. van Wengen	Haarlem
Joanna Werners	
Jit Narain	Livorno
Theo Damsteegt	Rotterdam
Chitra Gajadin	Suriname
Astrid Roemer	Paramaribo
Cándani	Suriname
Henna Goudzand	
Marcel Bénabou	
Gemma Pappot	
Piet Meeuse	
Jan van der Waals	
Maurice van Lieshout	
J.J.M. Bakker	Sloten
Lucy Kooman	
Peter van Ham	
Jack van der Weide	
Marc Kregting	Breda
Joy Arpots	
D. Frenkel	
J.W. Nobel	
Boris Todoroff	
Max Niematz	
Fleur Thomése	
Frans van Zetten	
Kees Hensen	
Fransje Klaver	
Elrud Ibsch	
Em. Kummer	Amsterdam
J. Neubauer	
Carel Peeters	Nijmegen
Maaike Meijer	Eindhoven
Jolande Withuis	
M. Weisglas	Den Haag
Klaas Koetje	
Michael Tophoff	Bremen
Conny Kristel	Amsterdam
Maarten Asscher	Alkmaar
Willem Schoonen	
J. Breman	Amsterdam
Ann Laura Stoler	
H.W.J. Drijvers	Winschoten
M. Stol	
Heather Sutherland	Australië
Maria Bosch	Amsterdam
Doris Edel	Zürich
Dorelies Kraakman	
Annet Mooij	
Kees van Hage	
Vincent Hunink	
R.Th. van der Paardt	
Piet Gerbrandy	Den Haag
Mieke Koenen	
Reinold Vugs	
Marja Loomans	
A. Bergsma	
Anita Wijzenbroek-Zoethout	
Sara van Epenhuysen	
P. Hijmans	
Cornelia Wilhelmina Bosch	
A. Agnes Sneller	
Odile Heynders	
Helenius Munt	
Irene de Jong	
C.M.J. Sicking	
D.M. Schenkeveld	Alkmaar
Fred Spier	
Marcel Kurpershoek	Den Haag
Julia Quak-Stoilova	Sofia
Frederike van der Leek	
Ed van der Elsken	Amsterdam
Herman Kaal	
Freek de Jonge	Westernieland
Mark Smeets	
Carla Rijkenberg	
Cees van der Pluijm	Radio Kootwijk
Ida Vos	Groningen
Karl Edersheimer	Rheinland Westfalen
Peter Buijs	
Barbara den Uyl	
Nelleke Noordervliet	Rotterdam
Helen Wilcox	
Ben van der Velden	Rotterdam
Wim Denslagen	
Joes Segal	
Gerard van Emmerik	Apeldoorn
H.C. Hemker	Amsterdam
Caroline van Eck	Katwijk
H. Bauer	Mayen
Repke Hollema	
Walter van der Kooi	
Philip Mechanicus	Amsterdam
C.W. van de Watering	
Peter Bergsma	Bergen
Léon Hanssen	Kerkrade
Casper Hakfoort	
P. Clausing	
Peter Drehmanns	Roermond
Nan van Houte	
Janny Donker	
Robert Steijn	
Ger Thijs	Rimburg
Karst Woudstra	
Tonie van Marle	
Marcel Möring	Enschede
Hana Bobková	Praag
Paul Binnerts	Den Haag
L. Frank	
Marianne van Kerkhoven	
Cas Enklaar	Den Helder
Ton Lutz	
Lien Heyting	
Marijn van der Jagt	
Loek Zonneveld	Heemskerk
Tom Blokdijk	
Otto Valkman	
Ritsaert ten Cate	Almelo
Hedy d' Ancona	Den Haag
Erik Slagter	
Siem Bakker	Oude Niedorp
Karol Lesman	Breda
Jan Blonski	Warschau
Jan van der Meer	
Goenawan Mohamad	Batang, Midden-Java
Herman de Kat	
Ton Hoenselaars	
Joep Leerssen	Leiden
Hans Goedkoop	
Jelle Koopmans	
Karin Tilmans	
Helen Gerretsen	
Niels Helsloot	
Tom van As	Den Haag
Ludo Abicht	Oostende
Madeleine van Strien-Chardonneau	
Margarete van Ackeren	
Dick Dooijes	Amsterdam
Otto Treumann	Fürth
Gerrit Noordzij	Rotterdam
Pieter Brattinga	Hilversum
Cees van Dijk	Goudswaard
Ad ten Bosch	Zutphen
Wim Crouwel	Groningen
Gerard Unger	Arnhem
Kurt Löb	Berlijn
Ger Kleis	
Paul Hefting	Eelde
Christoph Noordzij	
Melle Broeksma	
Peter Mertens	
Swip Stolk	
Frank Blokland	Leiden
Gitte Postel	
Margreet Schrevel	
Paul Beers	Den Haag
Sjaak Commandeur	
Frans van Dooren	Ravenstein
Marijke Emeis	Rotterdam
M. D'Hane-Scheltema	
Jeanne Holierhoek	
Frida Vogels	Soest
Kees Mercks	
Cora Polet	
Jean Pierre Rawie	Scheveningen
Mariolein Sabarte Belacortu	
P.H. Schrijvers	
Rien Verhoef	
Frans van Woerden	
Hans Vandevoorde	Zwevezele
Caroline Meijer	
Hans Henkemans	Den Haag
Ton Lemaire	
Marc Reugebrink	Goor
K.-J. Citron	
Micha Hilgers	
Kathinka Dittrich van Weringh	
Henri Beunders	Emmeloord
Erhard Blankenburg	Duisburg
Michael Hamburger	Berlijn
José F.A. Oliver	Hausach (Zwarte Woud)
Carla Bogaards	Voorburg
Bodo Kirchhoff	
Wolfgang Hilbig	
Ruurd Bakker	
Hubert van den Berg	Amsterdam
Peter Abelsen	
Frans Geraedts	
Edwin Krijgsman	
Lies Wesseling	
Tijn Boon	
Tijl Huygen	
J.C. Hess	
Dewijch Griffioen	
Herman Leenders	Brugge
Per Hojholt	
Annelies van Hees	
Barbara Noske	
Tomas Vanheste	
Jacques Arends	Gendt
Nanda van den Berg	Den Helder
Benjamin Biebuyck	Roeselare
Chris Keulemans	Tunis
Catherine Barel	
Fernando Venâncio	Portugal
Sophia de Mello Breyner Andresen	
Arie Pos	
Luís de Sousa Rebelo	Lissabon
Mário-Henrique Leiria	
Harrie Lemmens	Altweerterheide
Emile Schra	
Peter Brook	
Jan Ritsma	
Emanuel Overbeeke	
Frank Kouwenhoven	
Oswin Schneeweisz	
Benno Premsela	
Roeland Gerritsen	
Willy Coolsaet	Moorsele
Eva van Schaik	
David Vaughan	
Hans Snoek	
Kees Hogenbirk	
Ben Knapen	
Margriet de Moor	Noordwijk
Mark Richartz	
J. van Heetvelde	Enghien
Jean-Pierre Plooij	
Guy Widdershoven	
Wim Tigges	
Xandra Schutte	
Peter Verhelst	Brugge
Joris Verheijen	
Ed Leeflang	Amsterdam
Dago Steenis	
Peter Nijssen	
Frank vande Veire	
Atte Jongstra	Terwispel
Mario Gommeren	
Jan Hein Furnée	Leiderdorp
Carine Meulders	
Frans Kingma	
Kees Bruin	
Jorge Esquinca	Mexico-stad
Alexander Koesjner	
Annegret Böttner	
Dino Campana	Italië
Onno Kosters	Baarn
Weldon Kees	Beatrice, Nebraska
Simon Armitage	Marsden
Yves Bonnefoy	
John Ashbery	Rochester
Peter Handke	
Philippe Jaccottet	Moudon
Anne Duden	Oldenburg
Michael Donhauser	Vaduz
Michael Ondaatje	
Hans Kloos	
Bruno K. Öijer	
Franz Baermann Steiner	
Jacques Roubaud	
Olga Sedakova	
Ulrich Meister	Schaffhausen
Ad Beenackers	Bavel
Maarten van Delden	
Mario Vargas Llosa	
Juan José Arreola	
Juan Carlos Onetti	
Horacio Quiroga	
J.L.J. van Schoot	
Arnold Heumakers	
Dirk van Delft	
Johan Reyniers	
Hugo Dittberner	Duitsland
Esther Jansma	Amsterdam
Etienne van Heerden	Johannesburg
Gottfried Benn	Mansfeld
Roland Jaccard	
H.J. Houte	
Slavoj Zizek	Ljubljana
Thomas Elsaesser	Berlijn
Marc de Kesel	
Predrag Dojcinovic	Servië
Margreet Schouwenaar	Schagen
Geert Lernout	
Lucy Grealy	
Herman Cohen	Den Haag
Joh. R. Vlek	
Herman Philipse	
Anton Ent	Rotterdam
R.B. Kitaj	
Dorinde van Oort	
Dirk van Weelden	Zeist
Clarín	
Doeschka Meijsing	Eindhoven
Phillip Herring	
Günter Grass	
Jan Hontscharenko	
Paul Bogaert	Brussel
William Carlos Williams	
Chris Honingh	
Wieke Bonnier	
Eltjo Muntinga	
Marie de Meister	
René J. van Boven	
Jan Lampo	Antwerpen
Joris Denoo	Torhout
Frank Verkuijl	
Martien Kappers	
Johan de Boose	Gent
Else Lasker-Schüler	
H.C. Halberstadt-Freud	
Joke J. Hermsen	Middenmeer
Lut Missinne	Veurne
Thomas Leeflang	
Karen Vintges	
Christa Stevens	
Antoine Verbij	Boskoop
Winnie Sorgdrager	
G.M. Hopkins	Stratford
W. Bronzwaer	Heerlen
Rudy Bremer	Amsterdam
Saint-John Perse	Frankrijk
Claude van de Berge	Assenede
Monica Soeting	
Philippe Sollers	
Leonard Beuger	
Hans Achterhuis	Hengelo
Mark Boog	Utrecht
Peter Swanborn	
Graciliano Ramos	Brazilië
Gerard Nienhuis	
André Schmitz	Erneuville
Josef Winkler	Oostenrijk
Seamus Heaney	County Derry (Noord-Ierland)
Jan Eijkelboom	Slikkerveer
Bora Cosic	
Mattijs van de Port	
Ariejan Korteweg	
Zoran Djukanovic	
Rüdiger Safranski	Duitsland
Joost Niemöller	Haarlem
Thomas Rosenboom	Doetinchem
Magnus Hisrschfeld	Duitsland
Edouard Roditi	Verenigde Staten
Dieter Hülsmanns	Düsseldorf
Erik Zürcher	Utrecht
Maghiel van Crevel	
Chuan Xi	
Peter Buwalda	Brussel
O. Hammerstein	
Martijn van Calmthout	Eindhoven
Ole Bouman	
Menno Tamminga	
Jos de Wit	
Hein Groen	
Jan Heemstra	
Marc Schoorl	
Herman Koch	
Leon Gommers	Heerlen
Russell Artus	Tilburg
Peter Theunynck	Eeklo
Erik Menkveld	Eindhoven
Arjen Mulder	
Eric de Kuyper	Brussel
Wim Hottentot	
Peter Verstraten	
Basha Faber	Amsterdam
Klaus Theweleit	Duitsland
Manon Uphoff	Utrecht
Gert Hekma	
Leo Steinberg	Moskou
Yukio Mishima	
Jantine Oldersma	
Wislawa Szymborska	
Felicitas Hoppe	
C.F. van Beusekom	
Sven Danner	Amsterdam
Sjaak Koenis	
Kees 't Hart	Den Haag
Pam Emmerik	Amerongen
Joke van Leeuwen	Den Haag
Hedda Martens	
Charles Simic	
William T. Vollmann	
Wallace Stevens	
Nicolaas Matsier	Krommenie
Oek de Jong	Breda
Alain Robbe-Grillet	
Bart Verschaffel	
Karl Krolow	Hannover
Herman de Coninck	Mechelen
Yra van Dijk	
Goffe Jensma	
Koen Koch	Amsterdam
Rinus Ferdinandusse	Goes
Roelof Haveman	
Jan Willem Duyvendak	Markelo
L. Laeyendecker	
Yves van Kempen	Roermond
Joyce Outshoorn	
Wouter Vanstiphout	
Harry Oosterhuis	
Chris Rutenfrans	
Tom Schalken	
Pamela Koevoets	Vlissingen
Rob Schouten	Hilversum
W.H. Auden	York
Frank Reijnders	
Ciaran Carson	Belfast
Frits Abrahams	Nijmegen
Ed van Thijn	Amsterdam
Maria Stahlie	Arnhem
John Jansen van Galen	
Mirjam Schöttelndreier	
Thijs Wöltgens	Kerkrade
Ido de Haan	
Stella Braam	Haarlem
Irene Costera Meijer	Groningen
Jos de Putter	
Arnon Grunberg	Amsterdam
Helga Ruebsamen	Batavia
Michael Frijda	Amsterdam
Kees Bokweide	
Marjoleine de Vos	Oosterbeek
Chris Lorenz	
Jos van der Lans	
Jeroen Onstenk	
Kees Vreugdenhil	
Charles Reznikoff	
Jules Laforgue	
Matsuo Basho	
Gregor Laschen	
Lennart Sjögren	
Theodore Roethke	
Ernst Jandl	
Adolf Wölfli	
Joannes Six van Chandelier	Amsterdam
Martin Reints	Amsterdam
Johannes Bobrowski	Tilsit
Ted Hughes	Mytholmroyd
Caroline Lamarche	
Bibiana Mikkelsen	
Stine Jensen	
Hein-Anton van der Heijden	
Godert Posthumus	
Bart Moeyaert	Brugge
Tayeb Mokeddem	Algerije
Pierre Michon	
David Foster Wallace	Verenigde Staten
Göran Tunström	
Marcel Beyer	
Durs Grünbein	Dresden
Sasbout Beukelsz. v.d. Burch	
P.C. Verveen	
Mirna Velcic-Canivez	
Armand van Assche	Aartselaar
Bob Baljet	Haarlem
K. van Berkel	Amstelveen
Marijke Besselink	
Fred Dijs	
Otto Egberts	Vlaardingen
Roelof van Gelder	
Tijs Goldschmidt	Amsterdam
Harm Habing	
Hubert-Jan Henket	
Wim Hofman	Oostkapelle
Frederike Huygen	
Aad Kosto	Oegstgeest
Reinier Lucassen	
Fred Pelt	
Marieke Sanders-ten Holte	
Gary Schwartz	New York
B. Sliggers	
Jan Tromp	
R.P.W. Visser	
Bart Vos	
J.H. van der Waals	
Aryeh Lev Stollman	
Babet Mossel	
Matthé Sjamaar	
Huib Schwab	
Raj Kamal Jha	
Jelle Noorman	
Gijs van Oenen	
Koedooder & Heilig	20ste eeuw
Derek Walcott	Castries
Jacob ter Veldhuis	
Hans Onno van den Berg	2019
Gustav Herling	Kielce
Peter-Paul Verbeek	NA december 1970
Petran Kockelkoren	20ste eeuw
René Puthaar	
Erwin Mortier	Nevele
Martin Bril	Utrecht
Simon Frith	20ste eeuw
Pieter Cramer	20ste eeuw
Wouter Klootwijk	Rhenen
Ivan Nio	
Arjan Witte	Utrecht
Ko Kooman	20ste eeuw
Maarten Elzinga	
Peter Holvoet-Hanssen	Deurne
Miguel Declercq	Oostende
Paul Valéry	
Max Beckmann	Leipzig
Thomas Vaessens	Maastricht
José van Dijck	20ste eeuw
Brady Udall	20ste eeuw
Bert Meelker	20ste eeuw
Guus Middag	Haaksbergen
Robert Gernhardt	Duitsland
Gerrie Bruil	20ste eeuw
Joost Zwagerman	Alkmaar
Anton van de Wardt	
Jonathan Treitel	Groot-Brittannië (en Noord-Ierland)
Paul Alberdingk Thijm	Amsterdam
Jan Lodewijk Mercelis	Wechelderzande
Hilda Ram	Antwerpen
Hector Claeys	Oedelem (Beernem)
Hendrik Persyn	
Gustaaf Verriest sr.	Deerlijk
Hugo Verriest	Deerlijk
Henri Donders	
Eug. de Lepeleer	
A.M.J.I. Binnewiertz	
Alfons Jozef Maria Janssens	Sint-Niklaas
Delfien Vanhaute	Ardooie
Omer Karel de Laey	Hooglede
A.W. Sanders van Loo	
H.J.A.M. Schaepman	Tubbergen
Jozef Jacobs	
Prosper van Langendonck	Brussel
Jacob Lenaerts	
Aloïs Walgrave	Gent
Hendrik de Marez	Ronse
Jef Hinderdael	Gent
Pieter Danco	Antwerpen
C. van Ongeval	
Frans Drijvers	Rotselaar
Paolo Gentili	
Edward van Even	Leuven
Lambrecht Lambrechts	Hoeselt
Peter Jozef Tijsmans	Hoevenen
Adriaen Lourisz Lepel	
Desideer Claes	Neerlinter
A.G. Welvaar	
A. Weemaes	
Edward de Grijse	Roeselare
H. Sermon	Sint-Pieters-Leeuw
van der Veur	
Lambert Jageneau	
Caesar Gezelle	Brugge
John Lancaster Spalding	
Ch. Lucas	
Florimond Heuvelmans	Antwerpen
de Ticheleer	
Leo Goemans	Leuven
Adolf de Ceuleneer	Dendermonde
Mimosa	
August Victor Bultijnck	Knesselare
P.C. de Bruyne-Klinkenberg	
Melati van Java	Soerabaja
Martin Brants	Stokkem
Ed. Loos	
Jan Kornelis de Cock	Vierhuizen
Johannes Romboldus van der Lans	Den Haag
Arthur Wenthworth Powell	
Jan Craeynest	Oostrozebeke
A. Habets	
H. van Houtte	Waregem
G.H. Haastert	
Adolf Rutten	19de eeuw
Alphonse Naert	Brugge
Jan Stuyt	19de eeuw
Eugène Isebaert	19de eeuw
Alfons Mervillie	Wontergem
Eugeen Leën	Hasselt
P.L. van den Heuvel	19de eeuw
Jaak Boonen	
A. Prayon-van Zuylen	Gent
Simonart	19de eeuw
P. Rutten	19de eeuw
Constant Eeckels	Antwerpen
Henri W.J. Schouten	19de eeuw
H. de Vocht	
C. Callewaert	Deerlijk
Lodewijk De Wolf	Brugge
I. Vandegaer	
F. Palmen	19de eeuw
Herman Linnebank	
O. Cornet	19de eeuw
Hubert van Fall-Mheer	19de eeuw
H. Hosdey	Boezinge
Gustaaf Segers	Hoogstraten
Frans van Cauwelaert	Onze-Lieve-Vrouwe-Lombeek
Jean-Baptiste de Bethune	Brugge
D. Staroger	19de eeuw
A. Bertang	
Em. van Cappel	Brugge
A. van Eigenleven	19de eeuw
J.W. van Heeswijk	19de eeuw
Simon Staf	19de eeuw
Lodewijk Ontrop	Antwerpen
Alfons de Cock	Herdersem
Alfons Fierens	
Jozef de Voght	Broechem
J.A. van Lieshout	
L. Scharpé	Tielt
J. Lievens	
X. Smits	19de eeuw
J. Kautzen	19de eeuw
Jozef Muls	Antwerpen
D.A. Stracke	Antwerpen
H. Gabriëls	19de eeuw
F.P. Lorreins	
Eug. vander Heyden	
Lodewijk Vincent Scheltjens	Brussel
J. Jacobsen	
E. Vliebergh	
Emiel Hullebroeck	Gent
C. Clerckx	
E. van Fraechem	
J. Verest	
Alfons Siffer	Zomergem
Tom Bruce	
Leo van Nerum	
Dirk van Minden	
A. Carnoy	Leuven
Cl. Buvé	
I. de Vreese	
Omer Wattez	Schorisse
Albrecht Rodenbach	Roeselare
R. Maere	
W.W. Druenlanders	
Karel Elebaers	Antwerpen
Z. Peeters	
E.J. Mertens	
Alfons Moortgat	Opdorp
Thomas Ryetius	Mechelen
P. Henneckes	
Th. van Tichelen	Stabroek
Jan Franssen	
P.J. Stinissen	Peer
Titus Brandsma	Oegeklooster (bij Bolsward)
Stephanie Vetter	
Fr. Ludovicus Blomme	
D.A. Dyland	
R. Lemaire	
A.M. van Kersbeek	
L. Noël	
Floris Prims	Antwerpen
Em. Broes	
Gabriël Verborght	
A. Taelman	
B. van Kesteren	
L. van der Essen	
Jan Gessler	Maaseik
Felix Timmermans	Lier
J. van Mollé	
Johannes Theodorus Petrus de Groot	
Johannes van Well	
Octaaf Steghers	Eeklo
E. van Leuven	
Fr. Bertrand	
Julie van der Lans-Russel	
Arthur de Vos	
Gerrit Grijns	
F. Verhelst	
F. Dewitte	Brugge
H. Coppieters	
S.L. van Berne	
Ernest Claes	Zichem
J. Jos Kempenaers	
J.F. van Olmhof	
Juul Grietens	Meerhout
Petrus Dubois	
F. van Calloo	
Theo Brakels	
Jozef de Cock	Herdersem
Jules van Nuffel	Hemiksem
J.-J. Symoens	
M. Dewickere	Poperinge
V. Voorden	
Emiel Fleerackers	Turnhout
Ivo Struyf	Zaventem
J. Mees	
Dés. de Kock	
Arthur Meulemans	Aarschot
C.W. van Berkel	
Joseph Feskens	
Frans Delbeke	Roeselare
P. Petrus M. Janssens	
O. d' Hose	
P. Bertrand	
Albin van Hoonacker	Brugge
Jozef Arras	Lier
H. Mansion	
P. Soens	
Gust. Hens	
Arthur Coussens	Tielt
René Adriaensen	
A. Verstreken	
Jozef Vercoullie	Oostende
P. Placidus Eykens	
P. Hildebrand	
Jaak van Rettipo	
F. Michielsens	
Karel van de Vijver	
J. Mansion	
Berthold Missiaen	Westkapelle
E.H.Hendrik de Vis	
Goevaart	
Leo van Riel	
Aloïs Van Loy	
Armand van Veerdeghem	Sint-Gillis
Emiel van der Straeten	Antwerpen
Jan Bernaerts	Antwerpen
H. Brutsaert	
Cyriel de Baere	Baasrode
P. Janssens	
Ivo Cornelis	
Jan Hammenecker	Mariekerke (aan-de-Schelde?)
Sam Devriendt	
George Roose-Antonissen	
P.A. van Rooy	
Léonce Reypens	Mortsel
Aug. Bruijnseels	
Camille Poupeye	Veurne
A. van den Dries	
Henri van Deursen	
Jozef Simons	Oelegem
A.J. van de Perre	Geel
Marcel Romeo Breyne	Roubaix
J. de Berraly	
D. Logeman-van der Willigen	Deventer
A. van Beirendonck	
Victor Naveau	Tienen
Radvliet	
Jos Pierreux	Halle
Ivo Engelen	
E. van Dievoet	
J. Buelens	
Lod. van Mierop	Rotterdam
A. Lhorijn-Thans	
Leo van Dorpe	
Jan Job	
Aug. Bruynseels	
Jef Crick	Aalst
C. van Malten	
L.H. Smeding	
Maria Viola	Rotterdam
Edward Vlietinck	Oostende
Jaap van Manen	
Raphael Ligtenberg	
H. Pauli	
Rob. Ree	
L. Bril	
P. Berthold	
C.J. Vierhout	
Cyriel Verschaeve	Ardooie
Koh-i-noor	
Leo Speet	Turnhout
[tijdschrift] Van Onzen Tijd	
J. Caekbeke	
Edward Vermeulen	Beselare
Edward van Bergen	Antwerpen
K. Camerman	
Albert van Driessche	Grembergen
Paul van Alderman	
Juul Filliaert	Nieuwpoort
Joost Stokers	
Gery Helderenberg	Nieuwkerken-Waas
Johan van de Natuur	
Joh. van Dinter	Den Haag
Odo Siril	
Filip de Pillecyn	Hamme
J. de Porr	
Lodewijk van Eyck	Antwerpen
Joseph Laenen	Antwerpen
Maurits van Hoeck	
Frans Verschoren	Sint Katelijne Waver
Evermar van Moere	
J.F.M. Coveliers	Turnhout
R. Foncke	Mechelen
Florentijn Jan van der Mueren	Hoogstraten
V. Willems	
zuster Maria Jozefa	Turnhout
Dirk Vansina	Antwerpen
René Gaspar	Sint Katelijne Waver
Jan Boon	Halle (bij Brussel)
Wilhelm Scherer	Oostenrijk
Remy Saen	
Joris Caeymaex	Antwerpen
Lambert Aerts	
Leo Bittremieux	Sijzele
Josette Pasquasy	Antwerpen
August Nobels	
A.R. Vincke	
M.R. Pauwels	
Hilaire Allaeys	Woesten
Amaat Vyncke	Zedelgem
E.D. van Nuffel	
Julius de Wachtere	
Jozef Goethals	
P. Kubben	
J. Coenen	Elen
Jos. de Roeck	
Constant Lindemans	Opwijk
Lynn Doyle	
Alexander Elberts	Deventer
Jan Paquay	
L. Grootaers	Tongeren
A. van Langendonck	
Eva Moltesen-Hällström	
Karel Brants	
van Huffelen	
Hubert van de Weerd	Elen
Jef Scheirs	Oudegem
Prosper Poullet	
P. Thuysbaert jr.	Lokeren
Raynerius Podevijn	
Eugène Joors	Borgerhout
Hendrik Mande	Dordrecht
Eduard Amter	Leuven
Stephanus de Clippele	Denderleeuw
I.S. Toergenjev	
Jos. de Klerk	
Maurits Coomans	
A. Geerebaert	
Edmond Rubbens	Zele
Johannes Tauler	
A.L. Corin	La Louvière
J. van Malderen	
Edw. De Schaepdrijver	
Jozef van Reusel	Aarschot
Lode Monteyne	Antwerpen
Jan Bols	Werchter
Anton Van de Velde	Antwerpen
L. Debruyn	
Frisc over de Heiden	
Karel Pauwels	
B.H. Molkenboer	
Jos Vermeulen	Moerbeke-Waas
Oscar Monstrey	Moere
Clemens van der Straeten	Hasselt
Jos Spriet	
L. Uten	Diest
Semper Jejunus	
A. Nagels	
Joseph Coppens	
Mirza Riza Viham	
L. Seurinck	
J. Rombouts	Rumst
Stephanie Claes-Vetter	Zutphen
Arthur Boon	
R.V. Mortier	Izegem
Eugenius Druwé	
Gérard Philips	
J.A. Goris	
Charles Gillès de Pélichy	Brugge
J. Heyrman	
Odilon Demarre	Beveren
Leonie Weckx	
Julius Plancquaert	Wortegem
Hilarion Thans	Maastricht
Reinier Ysabie	Gentbrugge
Odilo Jacobs	Sint-Amands
J.P. Colsen	
Vincent Cleerdin	Hertogenbosch
C.H. de Ronde	
Joris Baers	Antwerpen
Th. De Ronde	Ekeren
E.H.J. Bernaerts	
Lydia van Kerckhoven	
Juliaan De Vriendt	
Alice Nahon	Antwerpen
D.F.F.J. Mercier	
K.L.M. Schoeters	
Clemens Daenen	Aalst
E. Jaulusz.	
Stan Dietvors	
Arnold van Praag	Amsterdam
Huib Hoste	Brugge
Oskar Katann	Oostenrijk
Eugeen van Oye	Torhout
Herman Deckers	Antwerpen
Mécs Laszló	
Richard Dewachter	Kalfort
André van Praag	
Ernest Closson	
Jan Chiapusso	Gemou
A.M. Pols	Antwerpen
L. van den Eynde	
Pierre De Clercq	
L. de Smet	
Jos. de Brandt	
Robert Grosche	Düren
E.H.J. Hallez	
Huib Luns	Parijs
Constant Godelaine	
August van Boeckxsel	
J. Groot	
Edgar Lee Masters	
Victorinus Groot	
Adolf ter Haghe	
Jef Notermans	Maastricht
Alfons Ariëns	Utrecht
Albertine Steenhoff-Smulders	Rotterdam
Rita Hostie	
F.S. van Bouwdijk Bastiaanse	Bemmel
Rob. Roemans	Gent
Theo Cruysse	
H.J. de Vleeschouwer	Dendermonde
Marc de Munnynck	Gent
Arnold Sauwen	Stockhein
Sigrid Undset	
C. Ldov	
Maurits S.C.M. Molenaar	Sneek
Robert van Passen	
Jeanne de Bruyn	Ekeren
Frans de Wilde	Antwerpen
Theodoor Belpaire	
Gottfried Hasenkamp	Bremen
Gabriël Merlier	
Paul Van de Woestijne	Sint-Amandsberg
Pol Douliez	
Hildegard van Bingen	Bermersheim
Aimé de Marest	Vlissingen
C. Vervaever	
J.F.J. van Tol	Amsterdam
Pol Heyns	Herentals
G. van Mulders	
Christian Rimestad	Frederiksberg
Johan Oskar Larsen	
Valfrid Palmgren	Stockholm
Erik Jespersen	
Joh. Nordahl-Olsen	Noorwegen
Karl Madson	Denemarken
Erling Lauhn	Stavanger
Peder Gram	Kopenhagen
Selma Lagerlöf	Sunne
Karl Gustav Ossianilsson	Lund
Edvard Welle-Strand	Bergen
Theo Findahl	Tvedestrand
Pertinax	Saint-Louis-de-Montferrand
R. van Pottelbergh	
F.A. Vercammen	Udenhout
Jan Bloem	
G. van Overbeke	
Ruth Schaumann	
Giovanni Vittorio Amoretti	Imperia
A. Della Corte	Napels
Arrigo Levasti	Modena
Guido Piovene	Vicenza
Cipriano Efisio Oppo	Rome
G.A. Borgese	Polizzi Generosa
Ada Negri	Lodi
Domenico Giuliotti	Val di Pesa
Michelangelo Zimolo	
Edgard de Bruyne	Ieper
Vincenzo Cardarelli	Tarquinia
Antonio Fogazzaro	Vicenza
Sergio Corazzini	Rome
Nicola Moscardelli	Ofena
Franco de Wyels	
Louis Knuvelder	Arnhem
Eugène de Hovre	Oudenaarde
Leo Picard	
J. Rodolfo Lozada	
Amado Nervo	Tepic
Rob van Roosbroeck	Antwerpen
Karel Verbeke	
Paolo Arcari	Forneaux
H.J. Elias	Machelen
Theo Bogaerts	Sint-Niklaas
Frank van den Wijngaert	Kontich
Paul Verbruggen	Boom
Ellen Russe	Zoeterwoude
Cornelis Backer	Groningen
Georg Moenius	Adelsdorf
Günther Müller	Augsburg
Friedrich Muckermann, S.J.	
Willem Gijssels	Dendermonde
Marcel Lobet	Braine-le-Comte
R.B. Lenaerts	
F. Collin	Antwerpen
Jozef de Wilde	
William van den Aker	Antwerpen
Andries Morlion	Diksmuide
Rudolf Arnheim	Berlijn
Karel Dekeukeleire	Elsene
P. Seligmann	
Lode Geysen	
L. Patris	
René Devos	
D. Lunders	
J.G.R. van Dyck	
Theodor Absil	
Staf Weyts	Mechelen
Lanceloot	
Stephanus G. Axters	Brugge
A.G. Christiaens	Beveren-Leie
Paul Sobry	Ieper
P. Vermeiren	
Paul Lebeau	Borgerhout
Alfons Walschap	
Fernand Bekaert	
Pomp de Basschaerde	
P. Morlion	
Em. de Deyne	
Han. Jonkers	
Oskar van der Hallen	Lier
Jef de Pillecijn	
Maurits Peeters	
P.J. Weckx	
Fernand Deschamps	Châtelineau
Peter Benoit	Harelbeke
Hugo Anns	
René Goris	
Paul Franck	
Walther von der Vogelweide	
Frans Verachtert	
L. Delwaide	
Jos. Wils	
Bert Ranke	
O. Westerlinck	
Joh. Boe	
Taeke de Groot	Amsterdam
H.H.J. Maas	Oostrum
D. Zijlstra	
Frans Tobback	
V.E. van Uytvanck	Antwerpen
Jef Contryn	
Leo Galle	
Jan Bertels	
Maurits de Doncker	Gent
Desiderius Erasmus	Rotterdam
J.L. de Belder	Lier
Thilda Deckers	
Korneel Goossens	Mechelen
Jan Kestens	
W.A. de Witte	
Leo Landsman	Gistel
Irma van de Port	
R. van Cauwelaert	
Marc Staels	
Max Lamberty	Sint-Gillis
Willy Vaerewijck	Deurne
Aloïs Janssens	
Fred. Walecijn	
Paul de Ryck	Erembodegem (Terjoden)
Marcel Grypdonck	
Novalis	Wiederstedt
Ludo Poplemont	
Luc Indestege	Zonhoven
Luc van Brabant	Lokeren
Liesbeth van Thillo	Edegem
Leys Achiel	
Karel Capek	
Max Kijzer	Amsterdam
Jean-Charles Snoy et d'Oppuers	Ophain-Bois-Seigneur-Isaac
J. Keunen	Hamont
P. Verberne	
Vital Celen	Hulshout
A. Plas	
Gilbert Degroote	Wakken
Robert Storm Petersen	
Stefaan Leonard	
Marie Schous	
H. van Lennep	
Marcel Tobie	
Luc van Hoeck	
Basiel de Craene	Waarschoot
Jan Melis	Beringen
P.Em. Valvekens	
Camiel van Deyck	
Hendrik Prijs	Sint-Truiden
Gerard Michiels	
Elmar Borg	
Jan D'Haese	Aalst
H. Brugge	
Robert Guiette	Antwerpen
Jo de Meester	
Xavier Pruszynski	
Waclaw Husarski	
Tadeusz Breza	
Waclaw Sieroszewski	
Kazimierz Tetmajer-Przerwa	
Venceslas Berent	
Emil Zegadlowicz	
Tadeusz Boy-Zelenski	
Leopold Staff	
Juljusz Kaden-Bandrowski	
Zofja Nalkowska	
I.K. Illakowicz	Vilnius
Ferdynand Goetel	
Zofja Kossak-Szczucka	Kosmin
Lambert Swerts	Hasselt
Julian Tuwim	Lodz
Jan Parandowski	Lviv
Antoni Slonimski	Warschau
Jaroslaw Iwaszkiewicz	Oblast Vinnytsja
Maria Jasnorzewska	Sopot
Herminia Naglerowa	Brody
Maria Dabrowska	Russów
Jozef Wittlin	Dmytrów
Jan Lechon	
Marja Kuncewiczowna	Samara
Eva Szelburg Zarembina	
Michal Choromanski	
Kazimierz Wierzynski	Drohobytsj
Jozef Czechowicz	
Swiatopelk Karpinski	
Jozef Lobodowski	
St. Pietak	
Amedée Arents	
P. Keymeulen	
Era Lobet	
Lode Quasters	Lanaken
Jos de Haes	Leuven
Elisabeth Dhanens	
George Meir	
August Corbet	
E. van Uytbergen	
Ventura García Caldéron	Parijs
Michel Demedts	
Filippo Donini	
Jan L. Broeckx	Antwerpen
Paul Walkiers	
Piet Zonderzorg	
Maria Huybrechts	
José de Ceulaer	
Aster Berkhof	Rijkevorsel
A. Kriekemans	
August Vanistendael	Birtley
Louise Labé	Lyon
Lode Cantens	Antwerpen
Nic van Beeck	Turnhout
J.L. Pauwels	
Honoré van Waeyenbergh	Brussel
Jan Valvekens	Rillaar
Frank Meyland	Gent
Abel J. Coetzee	Grootfontein
Gabriela Mistral	Vicuña
René J. Seghers	Hasselt
August Vercauteren	
Joris Dedier	
Firmin van Hecke	Ertvelde
Albert de Longie	Kruishoutem
Adriaan Magerman	Zottegem
John L. Brown	
B. Boeyckens	
Emiel van Hemeldonck	Zwijndrecht
Remi van de Moortel	Petegem-Deinze
Ant. Gobert	
Marcel Brauns	Hasselt
Gerard Verbeke	Waregem
W.J. Elsman	
Reninca	Puurs
Marius F. Valkhoff	Zwolle
C.M. van den Heever	Johannesburg
Paul Van Keymeulen	Erpe-Mere
Lode Campforts	
N. Wildiers	
Pierre Berteloot	Sint-Winoksbergen
Willem van den Broeck	
Willy Peremans	Bornem
Jan van den Broeck	
W. Vanbeselaere	Zevekote
Maurice Schuyten	
Émile O.J.J.G. Lousse	
R.K.J.E. Antonissen	
Karel Vertommen	Kontich
Fr. Nooyens	
Julia Tulkens	Tienen
Betsie Hollants	
Frans van Boogaerdt	
Rosa Temmerman	
Mona van Garsse	
Pieter-Emmanuel Oyen	
Maxime Deswarte	
Frans Verstreken	
Roover de Rik	
Yrjö Kaijärvi	Juuka
Hans Reykers	
W. Everaet	
Joos Florquin	Kessel-Lo
Jos van der Steen	
Henri Schoofs	
Gaston Duribreux	Oostende
Johan van Mechelen	Mechelen
Fr. Claessens	
Margriet Baers	Antwerpen
Hubert Verwilghen	
Raymond Pouilliart	
Adolf Herckenrath	Aalst
C.J. Lannoy	
Daan Boens	Oostende
Rik Zienstra	
Jan Leyten	
Joris Taels	Antwerpen
Albert Speekaert	
Roger Ghesquiere	
Andries Poppe	Wenduine
Erik van Ruysbeek	Brussel
Herman van Snick	Antwerpen
August Govaers	
Jules Van Ackere	Heule
Willem Doevenspeck	Borgerhout
Leo Simoens	Sint-Andries
Ernst Wiechert	
Charles van Lerberghe	Gent
Maurits Bilcke	
Friedrich Rückert	
S.J. de Hoest	Amsterdam
Frank Baur	Vilvoorde
Jan Elemans	Ravenstein
Luc Debaene	Antwerpen
J.J. Mak	Rotterdam
N. Machiavelli	
S.A. Vosters	Teteringen
Paul Possemiers	Antwerpen
Karel de Busschere	Oostnieuwkerke
Jos Smeyers	Kessel-Lo
Lode Wils	Antwerpen
M. Hanot	Peer
Tirso de Molina	
Eugène van Itterbeek	Kessel-Lo
Pierre Lambrechts	Laken
Fa Claes	
Roland Jooris	Wetteren
Hedwig Speliers	Diksmuide
Luc Verbeke	Wakken
Joris Delameillieure	
Robin Hannelore	Pulle
Anthony Jansen	Goes
Ludo Simons	Turnhout
Fernand Auwera	Antwerpen
Luc Clerinx	
J. Brants	Hertogenbosch
Reginald De Schryver	Gent
Ernest Schepens	Brugge
Frans Kuipers	
Luk Adriaens	
Julien Vangansbeke	Drongen
Frans de Haes	
Paul Vanderschaeghe	
Leo Pleysier	Rijkevorsel
Jef van Gool	Horendonk (bij Essen)
J. Goossens	
Jozef Boets	Lommel
Luuk Gruwez	Kortrijk
Frans Deschoemaeker	Kortrijk
Lucienne Stassaert	Antwerpen
Aleidis Dierick	Borgerhout
Rita Ghesquiere	Menen
José Lambert	
Wilfried Adams	Leuven
Frans Depeuter	Lichtaart
Chris Coppens	
Johanna Kruit	Zoutelande
Lisette Keustermans	
Willy Balyon	Den Haag
W.F. Jonckheere	
Patricia Lasoen	Brugge
Piet van Aken	Terhagen
J.P. Heyen	
Hervé J. Casier	Brugge
Hanna Kirsten	Tielt
Dirk Verbruggen	Mechelen
Jozef de Vos	
Hendrik Carette	Brugge
Marcel Janssens	Grembergen
Philip Vermoortel	Assebroek/Brugge
Elke Brems	Leuven
Bernard Verstraete	Zwevegem
Jo Gisekin	Gent
Robert Lagrain	Wingene
Koen Vermeiren	
Mark Kinet	
Katrien Desiere	
Willem de Groot	Delft
Chris de Stoop	
G. Geerts	
Johan Corveleijn	Oostende
A.B. de Cooman	
Stefaan Evenepoel	Strijtem
Charles Ducal	Leuven
Vic Nachtergaele	
Willy Vanhaelewijn	
Jan van Coillie	Tielt
Hans de Greve	
Michelangelo	
Lieven de Cauter	
Lenze L. Bouwers	Breezand
Lionel Deflo	Menen
Bernard Dewulf	Brussel
E. Dekker	
Toine Hovens	
Ernst van Altena	Amsterdam
Paul Koeck	Boom
Eric Derluyn	Roeselare
Marleen de Crée-Roex	
Julien Vermeulen	Roeselare
Annie Verhaeghe	
Bies van Ede	Badhoevedorp
Frank Pollet	Sint-Niklaas
Jan Flamend	
Kees Vellekoop	Rotterdam
Martine de Clercq	
Luc Huyse	Heule (Kortrijk)
Mark Van Tongele	
Elisabeth Marain	Brugge
Elisabeth Leijnse	
J.L. Weverbergh	Antwerpen
Marc Reynebeau	Kalemie
Frans Berkelmans	
Anne van Herreweghen	Ninove
Luc Renders	
Koenraad Goudeseune	Ieper
Gilbert Swimberghe	Brugge
Dante Alighieri	Florence
Luk Lambrechts	
Ray Gilles	Leuven
Marcel de Smedt	
Guido De Bruyn	Asse
Philips Koninck	Amsterdam
D. Delabastita	Leuven
Jef Snauwaert	Torhout
J.J. Roest van Alkemade	Dordrecht
Piet Couttenier	
J. van Iseghem	Brugge
Gaston de Mey	Kaprijke
Maurits van Saene	Ninove
Bert Govaerts	
Joris Gerits	Vilvoorde
Jean-Luc Lambreghts	
Bart Vonck	Brugge
Jean-Paul den Haerynck	Oudenaarde
J. Hoogteijling	
Bert Bevers	
Rino Feys	
Emile Clemens	
Mark Eyskens	Leuven
Raf de Smedt	Sint-Niklaas
Jo Govaerts	Leuven
Gilbert van Hool	Antwerpen
Publius Ovidius Naso	
Steven Wilsens	Peer
Francis Bacon	Dublin
Jan Vermeer	Delft
Ian	Gent
A.F.Th. van der Heijden	Geldrop
J.J. de Rooij	Amsterdam
Greet Vandepitte	Boma
Johan Reijmerink	
Edgar Degas	Parijs
Mark Verstockt	Lokeren
Herbert van Uffelen	
J.J. Grandville	Nancy
J.C. Kannemeyer	Robertson (Kaapland)
Els Vos	Antwerpen
Bart Janssen	
Dirk Geeraerts	
Ewoud de Kat	Vlissingen
Cees Verraak	
Jutka Rona	Boedapest
Kishin Shinoyama	Tokyo
August Thiry	
Hubert de Vogelaere	Maldegem
L. Beheydt	Izegem
Hartmann von Aue	
Hilde van Sumere	Beersel
M. Februari	Coevorden
Connie Palmen	Sint-Odilienberg
Jacques De Visscher	Gent
Leo Apostel	Antwerpen
Maryse Vincken	
Charley Toorop	Katwijk
Matteo Maria Boiardo	Scandiano
Hendrik Schreuder van Draag	
Robert Lema	
J.J. Goossens	Genk
Luc Devoldere	Kortrijk
Judit Gera	
Geert van Istendael	Ukkel
Serge van Duijnhoven	Oss
Paul Verhuyck	Antwerpen
Annemiek Neefjes	
Tony Le Duc	
Johan Daenen	Brussel
Yves T'Sjoen	Oudenaarde
Giovanni Bellini	Venetië
Victor Burgin	Sheffield
Kasimierz Bendkowski	Warschau
Elma van Haren	Roosendaal
Kaat Tilley	Mechelen
Ad Zuiderent	's-Gravendeel
Carl de Keyzer	Kortrijk
K. van der Stighelen	
Anna Enquist	Amsterdam
Luk van den Dries	
Eric de Volder	Sint-Niklaas
Eva Gerlach	Amsterdam
Ludo Bekkers	Antwerpen
François Haverschmidt	Leeuwarden
Jan Baetens	
Guido van Genechten	Mol
Lieven Baeyens	Wilrijk
Kristiaan Borret	Gent
Guido Vrolix	Tongeren
Pascal Cornet	
Rudyard Kipling	Bombay
Edgar Rice Burroughs	
Dominique Goblet	Brussel
Jan van Loy	Herentals
Galileo Galilei	Pisa
James Joyce	Dublin
Robbert-Jan Henkes	Eindhoven
Erik Bindervoet	Oostzaan
Joh. de Graaff	
Ultra Violet	
Mustafa Stitou	Tetouan
Walter Verdin	
Jan Lauwereyns	
Saskia de Coster	
Lucio Fontana	Rosario di Santa Fé
Geertrui Daem	Aalst
Monica Droste	Warschau
Guy Rombouts	Geel
Bob van Laerhoven	Arendonk
Didi de Paris	Leuven
Pjeroo Roobjee	Gent
Arthur Rimbaud	Charleville
Pieter Boskma	Leeuwarden
Dianne Hagen	Eindhoven
Marlene Dumas	
Wouter Verbeylen	
Eric Vos	
Hans Groenewegen	Haamstede
Idel Ianchelevici	Leova
Georges Wildemeersch	Brugge
Jan Cox	Den Haag
Geert Buelens	Duffel
Pierre Alechinsky	Brussel
Stefan Brijs	Genk
Jan Vaerten	Turnhout
Florent Wellens	Anderlecht
Maurice D'Haese	Lede
Frans Denissen	Hoevenen
Johan Vandenbroucke	Roeselare
Karl Vissers	
Erik Vlaminck	Kapellen
F.C. Terborgh	Den Helder
Ernest Michel	Eindhoven
Louis van Loo	
Jacob Bendien	Amsterdam
J.A. Dèr Mouw	Westervoort
M.B. Frenkel	
Karel Leroux	Zaffelare
Paul Rogghé	Gent
Stefan George	
Giacomo Antonini	Venetië
C.L. Sciarone	
B. Roest Crollius	Den Haag
Aulus Persius Flaccus	Volterra
J.C. Noordstar	Groningen
Plato	Athene
Fred Batten	
Amaat Honoraat Joos	Hamme
Rudolf Escher	Amsterdam
Piet Verhoog	Amsterdam
Gerard van Gelder	Middelharnis
E.M. Uhlenbeck	
A. de Buck	Oostkapelle
Grietje Drewes	
J.G. Bomhoff	
A.E. Cohen	Rotterdam
H.J. Drossaart Lulofs	
Karel Reijnders	Heerlen
A.A. Weijnen	Fijnaart
C. de Deugd	Alblasserdam
Karel van het Reve	Amsterdam
C.J. Ruijgh	
Z.R. Dittrich	Bratislava
H. Schultink	Amsterdam
G.W. Locher	Waspik
Frederik Willem Nicolaas Hugenholtz	Rotterdam
C. Soeteman	Rotterdam
P.E. Josselin de Jong	
J.C. Opstelten	Amsterdam
T.A. Birrell	
Simon Kooyman	
F.R. Kraus	
Christiaan Hooykaas	Amersfoort
D.J. Kohlbrugge	
A.B. Breebaart	
J.C. Anceaux	
A. Chorus	
J.H. Waszink	
A. Mooij	
F. Drijkoningen	
P.H. Pott	
J. M. Welcker	
J. van der Eng	
W. van Ravesteyn	Rotterdam
J.W. de Jong	Groningen
Frank C. Maatje	
J.H. Croon	
W.J. Verdenius	Den Haag
Wiecher Zwanenburg	
Antonie Cohen	
Jan van der Veen	
P.J.H. Pijls	
A. Kibédi Varga	
F. de Tollenaere	Ronse
F.R. Noske	
P.A.M. Geurts	Horst
I.N. Bulhof-Rutgers	
H. Mol	
W.J.H. Caron	Epe
Jacob Smit	Lekkerkerk
H.P.H. Teesing	Amsterdam
G. Nuchelmans	
F. Bulhof	Den Haag
W. Drop	Vlaardingen
J.A. van Dorsten	
G.F. Bos	
A.Z. van 't Hoff Stolk-Huisman	
J.J. Wesselo	
S.G. Nooteboom	
B.N. Teensma	
Louise Statenus	
A.A. Prins	
P.H. van Laer	
W.A.M. de Vroomen	
J.M. Bremer	
Steven ten Brinke	
D.R. Jonker	
T.A. van Dijk	Naaldwijk
Raoul Van Caenegem	Gent
P. Gaeffke	Breslau
J.G. Schippers	
A.L. des Tombe	
Ronald Landheer	
W. Hogendoorn	
A. Kraak	
Co Vet	Krommenie
L. Pepplinkhuizen	
A.W.G. Eijgendaal	
Sjaak de Mey	
A. M. de Wachter-Schaerlaekens	
H.J. Brinkman	
B.P.F. Al	
Guus Extra	
J. F. P. de Smit	
W. Kaper	
G.F.H. Raat	Amsterdam
M. van de Ven	
Horst A. Steinmetz	
Gerard Kempen	
D.J.M. ten Berge	
W.C. van Unnik	Haarlem
H.A.J.F. Misset	
C. Reedijk	Rotterdam
J.G.P. Best	
Jeanette van der Valk	
A.A. Verrijn Stuart	
Ger Schmook	Antwerpen
P.G.J. van Sterkenburg	
Paul van Hauwermeiren	
Alfred G.H. Kerckhoffs	
A. Ollongren	Kepahiang
Alain Bossuyt	
Harry van der Hulst	
A. Meintema	
Teun Hoekstra	
S.J. Lenselink	Rijsoord
Paul Pelckmans	
Th. van den Hoek	
Flor Aarts	
Ariane van Santen	
J. van Marle	
W. Pijnenburg	
Quirinus Ignatius Maria Mok	Amsterdam
Erik Maten	
D. Otten	
G.J. de Haan	
Arthur Eijffinger	
P. Th. van Reenen	
Marie-Louise Montulet	
Louk Wijsen	
A. Feitsma	Brantgum
Geert Koefoed	
Jos Hoogeveen	
Charles Grivel	
A.G.H. Bachrach	Frankfurt
Françoise van Rossum-Guyon	
A.J.A. Fehr	Alkmaar
L.D. Couprie	Den Haag
Willem Adelaar	Den Haag
J.A. Dautzenberg	Bocholtz
Jan van Bakel	
J.P. Fokkelman	Jakarta
Peter Verstegen	
Marijke Loots	
P.J. Peverelli	
Julia van Gunsteren-Viersen	
Frank Berndsen	
Jan Koster	Delft
M. Uhlenbeck-Winkel	
B.J. Hoff	
V.J.J.P. van Heuven	
J. Hoftijzer	
B.P. Visser	
Geert Adriaens	
Chantal Keijsper	Zaandam
Will Derks	
Ton van Haaften	
Maarten Klein	
Wim Zonneveld	
Ria Lemaire-Mertens	
Norval S.H. Smith	
Bert Schouten	
Erica C. García	
J. Knol	
Mineke Schipper	
Arie Verhagen	
H.F.A. van der Lubbe	Den Haag
H. Hulshof	
Erica Huls	
Sophie Levie	
Bob Rigter	
N. van der Laan	Rijsoord
Arie Schippers	
Ina Schermer-Vermeer	
Arthur Kooyman	
Annechien Vink	
H. Proeme	
Lo van Driel	
Dick Schram	
Johan Kerstens	
K. de Bot	
Kees-Jan Backhuys	
Rob Wolfs	
Ben van der Have	
Päivi Schot-Saikku	
Sandro Briosi	
M.K. van Dort-Slijper	
Harry Verschuren	
Jacqueline Bel	Den Haag
Peter van Bart	
Jeannette M. Hollaar	Den Haag
Aaldrik Koops	
Johan van Benthem	
Martin Schouten	Apeldoorn
Peter V. Zima	
M.P.R. van den Broecke	
P. Schellens	
René Marres	
Theo A.J.M. Janssen	
Marijke J. van der Wal	
Mieke Trommelen	
Gert de Jager	
A. Moerdijk	
Els Elffers	
Walter Haeseryn	
Reinier Salverda	Arnhem
Maartje Süter	
A.M. Duinhoven	
W.G. Klooster	
W.H.M. Mattens	
Margreet Onrust	
U. Schuurs	
Pierre Swiggers	
Willy Vandeweghe	Brugge
S. De Vriendt	Ukkel
Els Jongeneel	
Jacomine Nortier	
Essa Reijmers	
Ralf Grüttemeier	
Hub Zwart	
Ruurd R. Nauta	
Alida Toussaint-Dekker	Doorn
Robert S. Kirsner	
Sies de Haan	
J.V. Schmöler	
B. van Heusden	
Marinel Gerritsen	
J. Lachlan Mackenzie	
Matthijs Engelberts	
Hanneke Mulder	
Alied Blom	
Alette van Doggenaar	
Wardy Poelstra	
Hans van Stralen	
Pamela Pattynama	
R.H. Baayen	
Hans Anten	
Anneke van Luxemburg-Albers	
A. Sturm	
Justine Pardoen	
G.J. Vis	Blokker
Klaus Beekman	Berlijn
Saskia van As	
Guy Janssens	
Els Weijers	
Fritz A. Ponelis	Johannesburg
Sytze Wiersma	
Frank van den Bogaard	
Ger Groot	Amsterdam
Jan Noordegraaf	
Isabel Hoving	
A. Lubotsky	
Linda Verstraten	
Henk de Berg	
J.B. Berns	
Saskia Daalder	
L.H. Hoek	
Saskia Tellegen-van Delft	
Anneke Nunn	
Ann Rigney	
Frans Ruiter	
W.W. Mijnhardt	
José Sanders	
Peter Bakema	
J.A.M. Komen	
Matthias Hüning	Gescher
Wim Honselaar	
Wilma Siccama	
Tieme van Dijk	
Arnoud Wils	
Kees van der Waerden	
Els Andringa	
Walter Schönau	
Sjef Barbiers	
Leonie Cornips	
Margreet den Buurman	
Casper de Groot	
Ido Weijers	
Annelies Schulte Nordholt	
Marjolijn Verspoor	
Louise Cornelis	
Ute Langner	
Paul Hadermann	
Kees Snoek	Dordrecht
Fred Weerman	
Matthijs Bakker	
Ad Foolen	
J.D.F. van Halsema	
Henk Haverkate	
Edmond van Offel	Antwerpen
Jeannette Nijhuis	Doetinchem
A.M. Nachenius-Roegholt	Leeuwarden
Frans Hulleman	Amsterdam
Marie Heijermans-Peers	
H.A. van Daalhoff	
J.B. Schepers	Heerenveen
Bé Stolk	
Frits Leonhard	Amsterdam
R.A. Hugenholtz	
René de Clercq	Deerlijk
Alfred Boysen	
Henri Dekking	Rotterdam
David Moolenaar	
Leo Meert	Sint-Niklaas
Daan van der Zee	Schiedam
Suze la Chapelle-Roobol	Den Haag
Trabadoeli	
Willem Graadt van Roggen	Nijmegen
Carry van Bruggen	Smilde
E. Bergsma	
J.F. van Hees	
J. van der Burg-Hora Adema	
L.S. Hijlsma	
Fokko Bos	
J. van der Pant jr.	
Suze La Chapelle-Roobol	Den Haag
J.N. Pattist	
Jan F.E. Celliers	Wellington
Émile Verhaeren	Sint-Amands
Leonce du Catillon	
Jan Fabricius	Assen
Johannes Couperus	
Willem Frederik Schürmann	Rotterdam
Pauline le Roux	
Theocritus	
Albertine de Haas	
Robert de Hooghe	
Jules Bernard Schürmann	
Franz Michael Krings	Duitsland
Hendrik van der Wal	
Pieter van der Meer	Delft
Piet van Assche	
Dora Janssen	
Josef Cohen	Deventer
Jelte Nicolaas van der Ley	Haarlem
H.F. Wirth	Utrecht
Willem Caland	Brielle
Else Osten	
Albertine Draaijer-de Haas	Middelburg
Anna Elisabeth Buma	Ysbrechtum
R.L. Stevenson	Edinburgh
Henri H. van Calker	Waalwijk
Lita de Ranitz	Den Haag
Heinrich Petermeyer	
Balthazar Verhagen	Amsterdam
Henricus	
Adriaan van Slooten	
André de Ridder	Antwerpen
Gust van Roosbroeck	Antwerpen
Karel Antoon Casteels	
Janito Benavente y Martinez	Madrid
Herman van Puymbrouck	Antwerpen
Johan van Wageningen	
Remko ter Laan	Sluis
H. van Raalte-Simons	
Maryot	
Gabriële Violanti	
Anne Hallema	Tzum
Jos Janssen	Klerken
J. de Jong	
J.W. van Cittert	
Prosper Mérimée	
Bernard Canter	Utrecht
Carlo Goldini	
M.H. Werkman	
F.H. Fischer	Amsterdam
Johann Wolfgang von Goethe	Frankfurt am Main
D.A. Zoethout	
Hendrik C. Diferee	Amsterdam
Joseph O. Kronig	
Mies Kievits	Amsterdam
A.E. van den Tol	
Amélie de Man	
Marie de Rovanno	
P. Bierens de Haan	
Johan Gustaaf Danser	Kralingen
H.J. de Marez Oyens	Amsterdam
Herman Wolf	
A.G. van Kranendonk	Delft
Jeanne van Son-Willing	
Rhoda	
Jet Luber	Bussum
Ernst Groenevelt	Amsterdam
Charles van Iersel	Amsterdam
E.H. Teissen	
C.P. van der Weide	
J.L.M. Lauweriks	
Nella Moltzer	
Nelly M. Burgers	
C. Krak	
Fritz Smit Kleine	Haarlem
F.J. de Holl	
A. Moresco	Amsterdam
W.M. Ebbink	
Valborg Isaachsen-Dudok van Heel	
C. de Leeuw-Schönberg	
Rinke Tolman	Oosterzee
Jan Strobbe	
J. Saks	Grootschermer
Henriette Barbe	Rotterdam
W. Boschman	
A.A. Bosschart	Paramaribo
M.E. Klinkhamer-van Hoytema	
W. de Rijke	
H.S. Keuls jr.	
Heinrich von Kleist	
M.L.A. Barnardiston-Van Riemsdijk	
M.H.J. Schoenmaekers	Maastricht
W. Reich	
Jos Jansen	
Carla van Lidth de Jeude	
David de Jong	Amsterdam
Eduard van Collem	Amsterdam
Nanny Speyer	
Laura Olivier	
Georges Eekhoud	Antwerpen
M.D. Henkel	
Willem Johannes Steenhoff	Utrecht
W. Haanstra	
Alfred de Vigny	
J.C. Bruijn	
Alie Smeding	Enkhuizen
C. de Dood	
Maxim Gorki	
J.N. Jacobsen Jensen	
Herman Menagé Challa	
Ludvig Holberg	
H. Lievegoed	
Juul Roggeveen	
Henriette Geerling	
Jan Grégoire	Maastricht
D.H. Lawrence	Eastwood (Nottinghamshire)
H. Korteling	Deventer
Thomas Raucat	Parijs
Johan Schmidt	
G. de Bruijn	
Wouter Hutschenruyter	
H.W. van Loon	Rotterdam
J. Nienhuis	Delft
J.P. Zoomers-Vermeer	Rheden
Sidonie Gabrielle Colette	Saint-Saveur
Eva Raedt-de Canter	Breda
Taï Aagen-Moro	Amsterdam
Hermance Farensbach	
Annelies van Cauwelaert	
Juul Horn	
Ernst S. Willartz	
Marja Stevens	
Albert van Waasdijk	
Con Schröders	Amsterdam
N. de Praetere	
Willem Enzinck	Apeldoorn
Frans Harmen Kiveron	Soerakarta
A.H. Unger	
Friedrich Hölderlin	
J.A. van der Made	
Nico de Haas	Amsterdam
Frans Hannema	
Ferdinand Vercnocke	Oostende
Sjoerd de Vries	
Jan Redam	
Steven Barends	
Hendrik Lindt	
George Kettmann jr.	Amsterdam
Ben Moritz	
Henri Bruning	Amsterdam
Sybren Modderman	
Karin Moen	
Rudolf Steinmetz	
S.G. de Vries	Leiden
Louis D. Petit	Amsterdam
G.J.W. Koolemans Beijnen	Den Haag
J. Verdam	Amsterdam
Gerardus Johannes van der Hoeve	Gendringen
T. Zaaijer	Dirksland
J.M. Nuyts	
J.E. Banck	Soerabaya
Jan Frederik Willem Conrad	Maastricht
T.C. van der Kulk	Ridderkerk
W.R. Veder	
J. Herderscheê	Kamperveen
W.H. Stenfert Kroese	
H.J. de Dompierre de Chaufepié	Amsterdam
François van Veerdeghem	
B. van Meer	
Johan Adriaan Feith	Groningen
J.W.M. Schorer	Middelburg
Corneille L. Landré	Utrecht
Carel Eduard Daniëls	Hillegom
J. Jelgerhuis Swildens	Leeuwarden
J.G. Nijk	
Thomas Nolen	Rotterdam
P.J. Muller	
E.N. Rahusen	
Godschalk Horatius van Borssum Waalkes	Ysbrechtum
Wilco Julius van Welderen Baron Rengers	Leeuwarden
O.J.H. van Limburg Stirum	Utrecht
Jacob Cornelis van Slee	Hillegom
M.A. Gooszen	Eibergen
P. Feenstra jr.	
J.G.C. Joosting	Purmerend
J.T. Cremer	
J.J. Tavenraat	Kleef
Willem Polman Kruseman	Middelburg
Jan te Winkel	Winkel
G.H. Leignes Bakhoven	Utrecht
F.B. Löhnis	Rotterdam
J.M.L. Keuller	
Rijke de Wolf	
J.S. van Veen	
L.H. Slotemaker	Maassluis
R.A. van Sandick	
Thérèse Hoven	Den Haag
J.E. Heeres	Zuidhorn
Johannes de Hullu	Cadzand
Tj. Kielstra	Bolsward
Ludolf Willem Bakhuizen van den Brink	
Ernst Wilhelm Moes	Amsterdam
Frederik Pijper	Hoogwoud
W.A. Arriëns	
F.A. van den Heuvel	
J. Baart de la Faille	
J.H.W. Leliman	
W.W. van der Meulen	Leeuwarden
Is. van Dijk	Dussen
Hotse Brongersma	
R.W.P. de Vries	
L.J.J. Hageraats	
J.C. Vollgraff	Den Haag
J.C.G. Jonker	
A.P.Th. Eyssell	Den Haag
P.J.F. du Bois	
M.Th. Houtsma	
H.J. Calkoen	Sint Maarten
Jacob Domela Nieuwenhuis	Monnickendam
Y.H. Rogge	
Daniel de Swaef	Middelburg
L.J. Sicking	
D.A. van Heyst	
C.H. van Rhijn	Delft
Philip Christiaan Molhuyzen	Maastricht
J.C. Jansen	
Alexander Frederik de Savornin Lohman	Groningen
A.O. van Kerkwijk	
Willem Draaijer	Deventer
Eppe Wiersum	Uithuizen
J.P. Lotsy	
S. Cramer	Middelburg
H. Rogaar	
E.C. Godée Molsbergen	Utrecht
J.H. Abendanon	Paramaribo
Jan C. de Vos	Den Haag
F. van Gheel Gildemeester	
Seerp Gratama	Groningen
G. Fuldauer	
J. van Kuyk	
S.P. Haak	
A.F.O. Sasse van Ysselt	Waalwijk
D.A. van Waalwijk	
Johanna Snellen	Delft
G.E.W. van Hille	Zaandam
E.J. van der Brugh	
G.D.A. Jonckbloet	Eindhoven
R. van der Meulen Rz.	
Th. Morren	Utrecht
Hendrik Blink	De Wijk
Charles René Bakhuizen van den Brink	Elsene
P. Albers S.J.	
Marinus Willem de Visser	Stavenisse
B.J.F. Varenhorst	
H.J. Romeijn	
Joseph van Wely, O.P.	
F.J. Kruitwagen	Rotterdam
Martinus Beversluis	
E.A.A. van Heekeren	
E. Zuidema	
H.H. Juynboll	
Vincent Loosjes	Amsterdam
Ant. Averkamp	Cabauw
Joh. A. Leopold	Groningen
Reinier van der Meulen Rz.	Rotterdam
Jos. Jacobson	
Jan Kalff Jr.	
Frederic Adolph Hoefer	Sittard
J.H. Leopold	's-Hertogenbosch
M.G. Wildeman	
Th.P.H. van Aalst	
C.W.A. van Haersolte van den Doorn	
H.M. van Nes	Oostvoorne
Willem Vogelsang	
Klaas Uilkema	Grouw
L.W.A.M. Lasonder	Middelburg
E.T. Kuiper	Zwolle
Jan Leendert van Dalen	Dirksland
J.G.L. Nolst Trenité	
G.F. de Bruyn Kops	Haarlem
E.M. Meijers	Den Helder
Adriaan Beets	Utrecht
A.C.S. de Koe	Utrecht
E.C. van Leersum	Utrecht
H. Colijn	Burgerveen
A.J. Servaas van Rooijen	Utrecht
Maarten van Rhijn	Groningen
Valentijn Hepp	
J.J. van Hille	
A.A. Kok	Dordrecht
H.D.H. Bosboom	
W.J.M. Mulder	Amsterdam
C.J.K. van Aalst	
Johannes Henricus Scholten	Vleuten
W.J.J.C. Bijleveld	
M.A. Evelein	
J.C. van der Loos	
J.W. Bierma	
J.R. Callenbach	
F. van Hoeck	
J.C. Breen	Amsterdam
W. van Schothorst	Lunteren
Albert Eekhof	Steenwijk
Willem Gerard van der Tak	Den Haag
J.H. Garms jr.	
H.E. Knappert	
Frans Drion	Den Haag
Jacobus Heinsius	Amsterdam
R.W. Zandvoort	Avenhorn
Hendrik Bolkestein	
G. van Hoorn	
J.P. van Lonkhuijzen	
M.H.A. van der Valk	
Jo van Ham	Middelburg
J.S. Bartstra	Westerbork
Dirk Drijver	
Pieter Rink	
J.H. Kern	Leiden
H.T. Damsté	Huisduinen
A.A. van Rijnbach	Delft
Edward John Voûte	
S. Sybenga	
D. Plooij	
J.E. Kroon	Leiden
S.W.F. Margadant	Den Haag
Gillis André de la Porte	Boxtel
A. Goslinga	Bolsward
Johan Christoffel Ramaer	Zutphen
J.C. van Oven	Dordrecht
Dirk Herderschêe	
L.H.J. Lamberts Hurrelbrinck	Pasoeroean (Java)
J.P. van der Stok	
G.A. Wumkes	Joure
H.P. Berdenis van Berlekom	Heerlen
P.L. Tack	
A.S. de Blécourt	Appingedam
F.W. Stapel	Den Haag
J.E. Stokvis	Den Haag
M.A. van Andel	Gorinchem
Pieter Fijn van Draat	Deventer
Joh. F. Snelleman	
P.J. de Kanter	Gouda
V.H. Rutgers	Hertogenbosch
Jacobus Henneman	Alkmaar
G. Karsten	Zwaag
F.C. Wieder	Mijnsheerenland
M.E. Houck	Deventer
P.J.M. van Gils	Waalwijk
Caspert van Son	Dordrecht
Augusta Peaux	Simonshaven
J.H. Kuyper	
Jacobus Funke	Amsterdam
Marie C. van Zeggelen	Den Haag
Adolph Staring	Dordrecht
Th. van Rheineck Leyssius	Medan
J.P. Kleiweg de Zwaan	
Edgard Blancquaert	Opdorp
J.E. van der Laan	
Etsko Kruisinga	Leens
Johannes Berg	Sappemeer
J.J. de Gelder	
Bastiaan Adriaan Pieter van Dam	
J.H. van Lessen	Groningen
A.L. van Beeck	Baarle-Nassau
Johanna Dorina Hintzen	Vlissingen
Christine Mohrmann	Groningen
H.F. Wijnman	
Helbertine Anna Cornelia Beets-Damsté	Wilsum
Maria Hartgerink-Koomans	
Henri C.J.A. Mosmans C.ss.R	
Bruno B. Becker	Sint Petersburg
J.H. Broekman	
A. Brom	
P.W. Kamphuisen	Gouda
H.A. van Bakel	
Jo M. Sterck-Proot	
F.W. Grosheide	Amsterdam
G. Knop	Terschelling
David Kouwenaar	Amsterdam
D.E. Bosselaar	Utrecht
A.T. Vos	Appingedam
Louise Kaiser	Medemblik
Adriaan E.H. Swaen	Haarlem
W.J. Kooiman	
W.E. Boerman	Arnhem
J.H. Brouwer	Beetsterzwaag
Cor van der Lugt Melsert	
F.A. Le Poole	Leiden
Jacob Clay	Berkhout
Henri Mayer	Den Haag
F.J. du Toit Spies	Oranje Vrijstaat
F.B.J. Kuiper	Den Haag
Hendrik Wagenvoort	Barradeel (Friesland)
Abraham Rutgers van der Loeff	
Gerhard Sevenster	Beets
M.P. Vrij	Amsterdam
Johannes de Zwaan	
F.P. Huygens	
H.J.E. Endepols	Maastricht
J.L. Tadema	
Brocardus Meyer	
D.C. Tinbergen	Den Haag
M.E. Kronenberg	Deventer
A.C. van Waveren	Wijk bij Duurstede
S.J. van der Molen	Leeuwarden
W.F.J.M. Krul	
Gerard Ras	Utrecht
J.J. Kalma	Hantumhuizen
Chr.P. van Eeghen	Amsterdam
J.J. van Bolhuis	
P.J. Nienaber	Fauresmith (Prieska)
Arie Mout	Den Haag
H. de Buck	Oostkapelle
G.M. de Gelder	
P.H.G. van Gilse	Leer
J.W.J. Witsen Elias	Den Haag
D.P.M. Graswinckel	Utrecht
C.H. Lambermond	Nijmegen
H.J.J. Scholtens	Nuenen
J. Barten S.J.	
Willem van der Pluym	Zierikzee
C.J. Bleeker	Beneden Knijpe
H.E. Buiskool	Weerdinge
K.J. Riemens	Sliedrecht
T.S. Jansma	Amsterdam
P. Polman	Amsterdam
Rinske Visscher	Akkrum
W.R. Juynboll	
A.J. Sormani	
Alexander Sizoo	Gorinchem
A. Wassenbergh	
Gerrit Dekker	Pretoria
F.W.N. Hugenholtz	
R.A. Kern	
Cunibertus Sloots	Leiden
Hendrik Smitskamp	
M.A. Schwartz	Doetinchem
L.L. Hammerich	Kopenhagen
Onno Damsté	Leiden
S.J.R. de Monchy	Rotterdam
K. Fokkema	Leeuwarden
G.J. Sirks	
W. Roukens	Kerkrade
J.S. Schippers	
A.P. Grové	Potchefstroom
A.P. van Schilfgaarde	Den Haag
R.R. Post	Kloosterburen
M.E. Kluit	Utrecht
H.G. Cannegieter	Tzum
Frans Van Coetsem	Geraardsbergen
Maria Elisabeth Houtzager	
A.C. Bouman	Sommelsdijk
Rudolf Mengelberg	Krefeld
K.H. Miskotte	Utrecht
J.M.A.F. Smits van Waesberghe	Breda
T.J. Haarhoff	Paarl
G. Kazemier	Groningen
V.E. Korn	Den Haag
L. Brummel	Arnhem
M.J. Kloeke-van Lessen	
Margrit de Sablonière	
K.H.E. de Jong	Biebrich
J.F. Burger	
P.S. du Toit	Richmond
B.A. Vermaseren	Nijmegen
J.C. Winterink	Amsterdam
A.J. Veenendaal sr.	
A.H. van der Weel	Middelburg
Jan Tjittes Piebenga	Franeker
P.C. Boeren	Etten
F.L.W.M. Buisman-de Savornin Lohman	Amsterdam
K. Smits	
J.J. Buskes	Utrecht
Herman Gerrit Schulte Nordholt	
H. Hardenberg	
J.J. Poortman	Rotterdam
G.I. Lieftinck	Amsterdam
Johan de Meester jr.	Rotterdam
D.L. Daalder	Oosterend
S.P.E. Boshoff	Vaalbank
Frits Huël	Breda
Jan Ploeger	Noordbroek
G.P. van Itterzon	
W.C. Braat	Delft
A.J.J. de Witte	Roosendaal
E. Pelinck	
C.E. Pothast-Gimberg	Zutphen
Willem Schrickx	
G.S. Nienaber	Distrik Fauresmith
J.R. de Groot	Alkmaar
J.H. van den Berg	Deventer
H.A. Höweler	Amsterdam
J.C.P. Kats	Roermond?
Frits Lugt	
P.J.J. Diermanse	Den Haag
Willibrord Lampen	Alkmaar
F. van Lennep	
R.L. Plancke	Brugge
L.J.F. Wijsenbeek	
M.A. Beek	Ambt-Ommen
Max B. Teipe	
Hendrik Smilde	
K.Ph. Bernet Kempers	Nijkerk
J.J.M. Timmers	
I.Q. van Regteren Altena	
E. Schoenmaeckers	
P. Julius O.F.M. Cap.	
Dirk de Jong	Breda
Hans Edinga	Zeist
Jo Daan	Krommenie
M.A.P. Meilink-Roelofsz	
H.W. Meihuizen	Arnhem
Jean-Marie Gantois	Watten
A. Dirkzwager	
J. Bosch	
H. Draye	
R. Feenstra	Batavia
H.Th. Oostendorp	Zaandam
Ina Willekes McDonald	Haarlem
H.M. Mensonides	Breda
W.A. Nolet	Arnhem
Annie Versprille	Schoondijke
D.A. Tamminga	Winsum
H. Entjes	Ambt Rheine
Th. Nieuwenhuis	Noord Scharwoude
Daam Fockema	Leeuwarden
R.A.D. Renting	Winterswijk
J.U. Terpstra	Den Haag
Pieter Obbema	Sneek
Isabella Henriëtte van Eeghen	Amsterdam
Dina van Berlaer-Hellemans	
Hilda van Assche	Oudenaarde
G.W. Huygens	Rotterdam
H.T.J. Miedema	Heusden
Herman Balthazar	Gent
J.F. Heijbroek	
W.F. Lichtenauer	Rotterdam
A.F. Mellink	Amsterdam
S.A. Louw	
F.J. Snijman	Rietbron
Renaat Merecy	Antwerpen
H. Bonger	Amsterdam
Johan van der Woude	Groningen
J.A. Bornewasser	Voorst
Horst Gerson	Berlijn
Walter Thys	Antwerpen
G.A. van Riemsdijk	
P. Scherft	Jakarta
M.H. Schenkeveld	
W.J. Formsma	
Anna Jacoba Böeseken	Pretoria
Ernst van Heerden	Pearston (Oos-Kaap)
F.A. Holleman	Zutphen
Clasina Isings	
H.L.C. Jaffé	
Jan Cartens	Roosendaal
Tjaard W.R. de Haan	Den Haag
Kamiel Cooremans	
H.J. Prakke	Alphen a/d Rijn
Adriaan Verhulst	
B.A. Sijes	Amsterdam
Bernard Kemp	Hamont
B.H. Erné	Utrecht
Inez van Dullemen	Amsterdam
A. van Elslander	Gent
D.W. Bloemena	Enschede
J.Th. de Smidt	
S.B.J. Zilverberg	Amsterdam
T.T. Cloete	Vredefort
D. Nauta	Feerwerd
H. Berkhof	Appeltern
P. Spigt	Amsterdam
Harm Tjalling Waterbolk	Havelte
Gerda van Woudenberg	
W.P. Blockmans	
Frans van Isacker	Mechelen
F.R.J. Knetsch	Leiden
R.L.J. Bromberg	Den Haag
Sjeng Tans	Maastricht
R. Breugelmans	Rotterdam
Margreet Bruijn	Laren
Lyckle de Vries	
J.W. Oerlemans	Velsen
Antonie Maria Luyendijk-Elshout	Gorinchem
W.G. Noordegraaf	
Jan den Tex	Amsterdam
S.P. Wolfs	
N. Cramer	
W.A. Ornée	Groningen
Helen A. van den Berg-Noë	Semarang, Nederlands-Indie
H. Hoetink	
José de Mûelenaere	Ardooie
Oscar de Wit	Bandoeng (Java)
H.K. s' Jacob	
Kåre Langvik-Johannessen	Onsøy
E.J. van den Broecke-de Man	Yerseke
Annie Femmina Dekker	Koog aan de Zaan
A. Gruijs	
P.J. Koets	Macon (Georgia)
Klaas de Vries	
P.P.J. van Caspel	Amsterdam
W.J. van Hoboken	Amsterdam
Johan Ballegeer	Lissewege
J.G. Bruggeman	Den Haag
Elisabeth Keesing	Amsterdam
Caroline Rehorst-de Westenholz	Londen
A.Th. van Deursen	Groningen
Nop Maas	Hoensbroek
Bernt Luger	
Rob Tempelaars	
P. J. van Leeuwen	
C. Pama	
Jan J. van Herpen	Deventer
Klaas Iwema	
Willem de Blécourt	
C.C. de Bruin	Nijkerk
Martin Ros	
Ineke Bulte	
S.L. Verheus	Haarlem
F. van der Rhee	
Hendrik van Dijk	
F.C. Fensham	Heilbron
J.J. Huizinga	
Gerrit Jan Zwier	Leeuwarden
Marita Mathijsen	Belfeld
Frank Ligtvoet	
M. Stapert-Eggen	
L. Strengholt	Dordrecht
Majorie Bottenheim	Hilversum
Ares Koopman	
Dick E.H. de Boer	
P.P.V. van Moorsel	
Hans Werkman	Uithuizermeeden
Benno Barnard	Amsterdam
Jos Steegstra	
A.E. Kersten	
Ada Deprez	Oostende
J.E. Bogaers	
E.P. de Booy	
Hans Reeser	Amsterdam
Anne Wadman	Langweer
Wim Vermeer	
A. Leyns	
Maxim P.A.M. Kerkhof	
Rogi Wieg	Delft
L.J. de Ruiter	Zwolle
R.H. Pheiffer	
V.F. Vanacker	
Gerrit Valk	
F. van Elmbt	
Jan Brokken	Leiden
Willem Frijhoff	
J. Roelevink	
A.J.M. Linmans	
F.A. Brekelmans	Tilburg
Mart Janssonius	Godlinze
Willem Wilmink	Enschede
Wim de Bie	Den Haag
Peter J.A. Nissen	Swalmen
J.J.M. van Gent	Schipluiden
Hanna Blok	
J.C. Bedaux	
Willem G. van Maanen	Kampen
Joke Linders	
H. Duits	
M.G. Buist	Groningen
Johanna J.M. Meijers	
W.R.H. Koops	
Gé Vaartjes	Heerlen
Ph.H. Breuker	Schingen
S.N. Bakker	
M.C.A. van der Heijden	Oirschot
Joop van den Berg	Bondowoso, Java
Joost van der Vleuten	
P.B.M. Blaas	
Edwin Rabbie	Amsterdam
Peter van Beek	
Wilhelmina Christina Pieterse	
S. Groenveld	
Wolther Kassies	Oldenzaal
Ton Harmsen	Den Haag
Lieve Joris	Neerpelt
N.F. Streekstra	
Jaap de Moor	
J. Trapman	Voorburg
C.G. Santing	
G.H.M. Posthumus Meyjes	Amsterdam
Ingrid Moerman	
J. Gerritsen	Wildervank
Frans Claes	Webbekom
H.J.M. Nellen	Horst
Kees de Bakker	
Auke Jelsma	Amsterdam
K.J. Bostoen	
C. Augustijn	Rotterdam
A. de Groot	
Marijke Meijer Drees	
B.P.M. Dongelmans	Alphen a/d Rijn
Jan-Wouter Zwart	Oss
Ernestine van der Wall	Ermelo
G.R. Zondergeld	
Willem Mooijman	
A.E.M. Janssen	
Diederik Grit	
Hans Renders	Aarle
Jeanne Roos	Utrecht
Wim J. Simons	
Bart Jan Spruyt	Ridderkerk
E.P. Meijering	
Theo Verbeek	
A.M.L. van Wieringen	
G.W.B. Borrie	Bergen op Zoom
R.C.J. van Maanen	Utrecht
Geert Mak	Vlaardingen
Otto S. Lankhorst	
Rob van de Schoor	
A.D.A. Monna	
J. de Groot	
Ann Van Sevenant	Torhout
Eric M. Moormann	Boxmeer
Joan Hemels	
J.T. Bremer	
Marten Toonder	Rotterdam
Robert Lemm	Rotterdam
Arthur Japin	
Siegfried Huigen	
Cees Fasseur	Balikpapan
C. Moeyaert	Sint-Andries
Th.M. van Leeuwen	Delft
A. Maljaars	
Fred van Leeuwen	Maastricht
Robert van Amerongen	Alkmaar
Els Stronks	
Sal Tas	Amsterdam
Johan Valkhoff	Schiedam
J.P.B. Josselin de Jong	
Joseph Campbell	
Louk E. Roest Crollius-van Doorn	
Tjoe-Som Tjan	Jakarta
W. Cahn	
E. Lopes Cardozo	
S. Mok	
R. Hoetink	
A.J.W. Kaas	
J.C. van Broekhuizen	
M. Coutinho	
Hannah van Wieringen	Haarlem
G.H. Slotemaker de Bruine	Beilen
Dirk Jorritsma	
Arnold Jan Pieter Tammes	Groningen
Max Dendermonde	Winschoten
Jef Suys	Groningen
Henri Francois Técoz	
J. in 't Veld	
H.J. Hellema	
H. van Wieringen	
Hans Redeker	Oudenrijn
Raden Mas Djojowirono Soenito	Indonesië
Gerard Reve	Amsterdam
Henriëtte Mooy	
A.C. Willink	Amsterdam
Til Brugman	Amsterdam
Emile Gobée	Den Helder
Joke Moeljono	Indonesië
Marijn van Dantzig	
E.L. Levie	
Montanus	
S. Davids	
Ramón Gómez de la Serna	Spanje
Johannes de Graaf	
A.S. de Leeuw	Amsterdam
L. de Jong	Amsterdam
Jan van Lumey	Batavia
J.C.M. Kruisinga	
J.J. Poelhekke	Utrecht
U. Huber Noodt	Zierikzee
G.A. Watermeyer	
M. Sybr. Koops	
Lilo Linke	Berlijn
F.R.J. Verhoeven	
Louise Moor	Haarlem
Harriët Freezer	Den Haag
G. van den Bergh	Oss
Sjoerd van der Schaaf	Gorredijk
Gerrit Pleiter	
Nicolaas Wilhelmus Posthumus	Amsterdam
Paul Catz	Rotterdam
J.F. Engers	
H. Vos	
Cornelia Brinkman	Delft
J.M.C. Bouvy	Dordrecht
Fazil Bey	Akkon
Amr il Kaïs	
N. Krusemeyer-van Iersel	
Ph.C. van der Pant	
Joseph Leftwich	Zutphen
J.M.E.M.A. Zonnenberg	
Noegroho	
Thomas Mann	Lübeck
Norbert Loeser	Berlijn
Marcel Minnaert	Brugge
Bart Landheer	Rotterdam
Luuc Kooijmans	
Hieke de Jong	
Pearl S. Buck	Hillsboro, West Virginia
W.H. van Dobben	Weidum
Konstantínos Chatzópoulos	
J.L. Snethlage	
Hendrik de Waard	
Max Brod	Tsjechië
D.C. van der Poel	
Margarita Nelken	Madrid
Libbe van der Wal	Gorredijk
P.J. Stolk	
Pieter Minderhout	
T.H. Thung	
Bernard van Delfshaven	
A. Lemair	
Matthijs Bokhorst	Rotterdam
W.F. Heinemeijer	Amsterdam
Joseph Ismael	
R.J. Forbes	Breda
Jan Slagter	Woerden
B. Sluimers	
J. Haak	
Anthon van der Horst	
J.M. van Veen	
C.A. van Peursen	
E. Meyer-Brouwer	
Sk. Muljadi	Indonesië
Chairil Anwar	
P. Sengodjo	Indonesië
J.H. Willems	
Albert van Hoogenbemt	Mechelen
H. Nijhoff	
Strátis Myriwílis	
Netty van Kempen	
Hazil	
Hermann Kesten	
Marion Coulon	
Rico Bulthuis	Den Haag
G.M.S. Kranenburg Haan-Schmidt	
J. Landsheer	
Olaf J. de Landell	Cirebon (Java)
Arthur Constandse	
Damida Reynders	
E.H.F. van der Lely	
A.F. Coenen	
R. Cointre	
S. de Wolff	
Jac. de Graaf	
Jean Leclercq	
Willem Hussem	Rotterdam
Asrul Sani	
L.A.J. Torfs	
Coert Poort	Rotterdam
Fr. de Jong Edz.	
Klaas van der Geest	Schiermonnikoog
Andries Sörensen	
Rogier van den Gouden	
J.D.P. Warners	Heinkenszand
G.J. Renes	
J. de Boer	
Frits van Deventer	
Johan de Vries	
Rennie Elisabeth Veenstra	
Jan van Zutphen	
Willem de Geus	Den Haag
Renee	
J.P. Mazure	Rotterdam
Johan Betzema	
S. Kleerekoper	Amsterdam
Pablo Picasso	Málaga
P. Hoekstra	
Jan Fekkes	Groningen
F. van Sandwijk	
Pramudya Ananta Tur	Blora, Midden-Java
Guus Vleugel	Goes
Bertien Buyl	Ledeberg
Jórgos Theotokás	
Basuki Gunawan	Indonesië
Jan Pedroli	
Gila Dotan	
Johan van der Bol	
Cor Stutvoet	
Lorenz de Swaan	
W.H.C. Tenhaeff	
Dirk Jan van der Laan	Zwolle
Henk Holtrop	
Christine Meyling	Hengelo
Sietse van der Meulen	
E. Brongersma	
H. Meyers	
Tone Brulin	Antwerpen
Joris Vriamont	Lijsem
D.P. Blok	Oegstgeest
G. Mannoury	Wormerveer
Ti Woe	China
Po Tsjü I	China
Dzjen Tse Loeng	
Soendoro Tirtosiwojo	
Anton Jonckbloet	
Wim Kan	
Soedjatmoko	Sawahlunto
C.L. Kruithof	
F. van der Kooy	
Ichiro Ando	Japan
E. Rijgersberg	
Elizabeth van Stappen	
Insider	
L.F.A. Granberg	
I.F.M. Salim	
P. Valkenburgh	
W. Scheffer	
H.A. Tolhoek	
A. van Marle	
L. Sluimers	
Sake Helder	
A.K. Rottiers	Sint-Niklaas
Albert Kok	Singapore
Apie Prins	Heemstede
Herman Uyttersprot	Denderbelle
Herman van Poland	
J.C. Kamerbeek	
Elisabeth Siriks	
P.E.G. van Heyningen	
Tine Leiker-Kooijmans	Den Haag
Joh. Betzema	
Carlo Schmid	Perpignan
Jaap Kruithof	Antwerpen
Leo Peters	
Gabriel Celaya	Spanje
Garsiasol	Spanje
Luc van den Briele	Ieper
T.W.L. Scheltema	
Hugo Maron	
J.A. van der Vlis	
F.W. Michels	
H.P. Plantenga	
Helma Wolf-Catz	Nieuw en Sint Joosland
Hans Andreas Cornelius Roem	
C. Houwaard	
W.C. Feltkamp	
E.F. Tijdens	Uithuizen
Loe Hsuun	China
Bergman	
J.C. van Leur	
Johan van Os	
Swan-Liat Kwee	
Manja Croiset	
J. Bronowski	Polen
Henk M. Beumer	
Rudo Durant	
John den Admirant	
Hans Reddingius	Jakarta
Ronny van Cleef	Amersfoort
Ellen Warmond	Rotterdam
Eugène James	Marigot/St. Martin
Friederike Granberg	
P. Hoogenboom	
Henk van Maurik	
A.J. Cnoop Koopmans	
Pszisko Jacobs	Haarlem
J.H.L. Laps	
H. Furstner	
A. Wildeman	
Charles Meeking	Australië
Naoya Shiga	Ishinomaki
Th. van Tijn	
Maria van der Steen	
C. de Groot	
Germaine Tillion	Frankrijk
Birage Diop	
Léopold Sédar Senghor	
A.H. Wertheim-Gijse Weenink	Veenhuizen
Johan Achterhof	
G. van Geffen	
T. Haan	
A.K. Datta	
Paul Citroen	Berlijn
Gerrit Rietveld	Utrecht
Willem Andriessen	Haarlem
Jan Schepens	Gent
Paul Groenendaal	
Jacques Dewaele	Oostende
Wim Gijsen	
C. Ch. Mout	
Katsumi Tanaka	Japan
Shigeharu Nakanó	Maruoka
José María de Semprún Gurrea	Madrid
Miguel Hernández	Alicante
Francisco Carrasquer	Albalate de Cinca
Blas de Otero	Bilbao
Ramón Lugris	Ferrol
Luis Araquistain	Bárcena de Pie de Concha
Prosper de Smet	Gent
Emmy Kerkhoff	
S.H. Meijler	
Derk de Vries	
Arnold Jan d' Ailly	Franeker
Margaretha Ferguson	Arnhem
Lieuwe Hornstra	
Zbigniew Ogonowski	Warschau
John Drager	
Adri Laan	
Leo Rikmenspoel	Amsterdam
Jan Knappert	Heemstede
Wanda Maya	
Henriëtte Boas	Amsterdam
L.C. Biegel	
K.L. Roskam	
L.O. Schuman	
Cor de Groot	Amsterdam
R.C. Winter	
A. Wachter	
D. Elema	Ezinge
C.J. Huizinga	
Cora Vreede - de Stuers	
Petronella Everdina Eldering	Rotterdam
Jan Janze	
H.H. van Kol	Eindhoven
Ingrid Jonker	Douglas
Fred van Wijck	
Ank Steenis	
H. van der Ploeg	
Wessel Scheffer	Amsterdam
P. Glazema	
L. Kolakowski	Polen
S.H. Delhaas	
Maria de Groot	Wormer
H.G. Surie	
F. Roels	
G.J.P. Cammelbeeck	Utrecht
A. de Roos	
Ben Groeneveld	Breda
J.B. Bakema	
Marcel van Matena	
Oscar Mohr	St. Petersburg
B.C. van Houten	
Paul van der Loeff	
Jac. Wolsink-Schouten	
E.J. Spliethoff	
C.W. Rietdijk	Bergen op Zoom
Mark Braet	Nieuwpoort
Pandelis Prewelakis	
E.B. Mayer-Swart	
P.M. Croiset	
Eveline van Deth	
Caroline F. Ware	
J. Dhont	
Gerard Heederik	Doetinchem
S. Na'aman	
Margreet Koekebakker	
Reinout Vreijling	Schiedam
Inne de Jong	Nijemirdum
J.J.P. Oud	Purmerend
Roger Serras	Gent
Michele Ondei	
Steven Membrecht	Amersfoort
Heinz Neudecker	
W. de Vries	
Daniël van Ryssel	Evergem
W.J. Jong	
A.J. Vermeersch	
D. van der Meulen	
Rafael Alberti	El Puerto de Santa María
Sippora Stibbe	Zwolle
Clem Schouwenaars	Mortsel
Piet Sterckx	Tienen
Lieuwe H. Bouma	Arnhem
R. Cordes	
Jozef Eyckmans	
G. Th. Ruttenberg	Utrecht
J. ten Brink	
Anna Muntjewerf	
Jan Vanhaelen	Machelen
Ward Ruyslinck	Berchem (Antwerpen)
Nic van Bruggen	Merksem
Carla Walschap	Antwerpen
Roger Binnemans	
J. Kreykamp	
Maxim de Winter	
Fedde Schurer	Drachten
H. Wouters	
Krine Boelens	
Fem Rutke	Gouda
Inge Tielman	Java
Jeroen Brouwers	Jakarta
Georges Fukkink	
R.V. Leembruggen	
Clarissa Jacobi	
Loek den Hoef	
D.A.L. Schröder	
G.J.M. van het Reve	Enschede
Werner Cranshoff	
Jerzy Holzer	Warschau
Malgorzata Hillar	Piesienica
Jerzy Sito	Pinsku
Jan Balicki	Polen
Tadeusz Rózewicz	Radomsko
M. van Hulten	
J. P. Schuyf	
Mieczyslaw Jastrun	Korolowka
Kazimierz Gromski	
Bob Carlier	
H.Th. Chabot	
J. van Wijk	
Julien Vandiest	
A.J. Koejemans	
J. Dommisse	
H.J. van der Mei	
N. van Hees	
Joop van Tijn	Batavia
W. Langeveld	
Roger van de Velde	Boom
N.C. Clegg-Bruinwold Riedel	
Jan Noort	
L.H. van der Tweel	
Th.J. Hooning	
Tsjou Li-po	China
J.H. de Haas-Posthuma	
René Dekkers	Antwerpen
Bruce Burton	
Klaas Schipper	
M.J. Broekmeyer	
K. Kuiper	
Bruno Walschap	
Jos Vandeloo	Zonhoven
M. Rácz	
H.H. Kirchheiner	
W. van der Marck	
Alex Bolckmans	
J. van Santen	
Frank Liedel	Antwerpen
G.G. Bauman	
Maarten van Dullemen	
Gérard van Kalmthout	
Wouter Kotte	
René Louis Gysen	Antwerpen
Kazimir Malewitsj	Kiev
Ann Smith	
S.J. Rutgers	
E. Standaert	
H. van Strien	
Jan Messchert van Vollenhove	
Albert Verwey	Amsterdam
Roelof Schuiling	Annen
Jan Gerrit Talen	Amsterdam
E. Rijpma	Nijkerk
Klaas Poll	Grijpskerk
Theo Thijssen	Amsterdam
J.H. Swildens	Voerendaal
K. Veenenbos	
Antonie de Vletter	Den Haag
Ph.J. Simons	
J.J. Woltjer	
J.L. Horsten	Tilburg
Jacob van der Valk	
G. Engels	
M.R. Dijkman	
J.A. vor der Hake	Loenen
J. Verboven	
Lodewijk Makeblijde	Poperinge
A.J. de Jong	
Ezechiël Slijper	Amsterdam
M.A. van Weel	
H.A. Westrate	
Gerrit ten Bruggencate Hermz.	Almelo
Joh. Jac. Smith	Rodezandskloof
E.J. Haslinghuis	Rotterdam
F.P.H. Prick van Wely	Oud-Vroenhoven (bij Maastricht)
Yvonne Koop	
Aert Schouman	Dordrecht
E.J. van Sonsbeek	
R. Wijkman	
C.F. Krijs	Amsterdam
B.M. Noach	
Jos. Schrijnen	Venlo
A. van Herk	
D. Haagman	
A.S. Bijl	
E.G. Courrech Staal	
M.H. van de Ven	
Joannes van der Elst	Sint-Niklaas
Th. de Jager	
Jac Heeren	Hertogenbosch
S.A. Krijn	
F. den Eerzamen	Goedereede
K. Kooiman	Oudshoorn
Karel Lantermans	
K. Blokhuis	
J. Hoeksma	Drogeham
P. Koster	
J.J. le Roux	
F.A. Stoett	Leeuwarden
K.W. de Groot	
J. Kooistra	
Wobbe de Vries	Noordhorn
G.E. Opstelten	Amsterdam
R. Kaltofen	
J.M. van der Hoogt	
Abraham Kuyper	Maassluis
J. van der Baan	Zierikzee
Erik Wellander	
P.H. Greiner	
D.B. Bosman	Boshof
Elisabeth Jongejan	Amsterdam
H.H. Knippenberg	Maastricht
E.C. Pienaar	Hoëkraal (district Potchefstroom)
L.P.H. Eykman	Nijkerk
K.H. de Raaf	
Andries Borgeld	Sappemeer
Maria Simon Thomas	Rotterdam
Tj. Sterringa	
G.A. Brands	Zutphen
W. van den Ent	
W.L. Bezema	
Reind Kuitert	
W. Kraak	
Luc Salu	
L. Koch	
Th.B.F. Hoyer	
L.J.J. Olivier	
R. Pennink	
J. van Rijckevorsel	
J.C. van der Does	
A. Kuiper	
A.J. Schneiders	Obdam
J. Hovy	
René van Sint-Jan	Buizingen
M. Buisman J. Fzn.	Rheden
Jacob Hiegentlich	Roermond
W.G.J.A. Jacob	Grave
G.J. Uitman	
F.C. Driessen	Arnhem
F. Jansonius	
Dirk Gerhardus Muller	Hengelo
Marie H. van der Zeyde	
Ulfert Schults jr.	
Roelof Schokker	
Lodewijk Maerevoet	
Franz Staude	Wenen
Anton Reichling	Nijmegen
Jan van Dam	Amsterdam
H. van Wichert	
C. Wilkeshuis	Harlingen
Riemer Reinsma	Zaandam
A.R. Hol	Ingen
L.A. te Winkel	Arnhem
Th.H. d' Angremond	
C.L. Thijssen-Schoute	Wageningen
M. Mendel	
D.H. Smit	
Annick De Vylder	
Eugène de Bock	Borgerhout
T. Langeveld-Bakker	
M.H. de Haan	
G.G. Ellerbroek	
M.M. Prinsen	
P.C. Schoonees	Uniondale
H. van de Graaf	
J.H.J. Willems	
J.J. Soons	
A.C. de Jong	
A.M. Korpershoek	
C.G.L. Apeldoorn	Maastricht
Mirjam Ernestus	
Paul van der Meulen	Leeuwarden
H. Bovenkerk	
B.H. Kazemier	Groningen
C.W. Schoonhoven	
J. Karsemeijer	
F.G.A. Stemvers	Rotterdam
Ch.A. Thomas-Bourgeois	
U. Tuinstra	
B.H. Peteri	
H.B.A. Bockwinkel	
G.A. Mesters	
Luc. Boreel	Amsterdam
W.H.N. van Wel	
J.P. Prins	
Helga Van Geertsom	
Johan Moorman	Hulst
F.N. Jansen	
P. Stienstra	
Chr. Stapelkamp	Loosdrecht
J.M. Willeumier-Schalij	
A.P. Kieft	
D. van Unnik	
H.L. Bezoen	Enschede
H.J.A. Hissink	
G.M.J. Duyfhuizen	
M.J. Jochems	
Judi I.H. Mendels	
G.A. Sybenga	
F.G. Hesmerg	
J.F. Hengeveld	
J. Naarding	Sleen
A. van Mourik	
L.H.M. Muris	
Honoratius Sengers	
P. Maximilianus O.F.M. Cap.	Moerdijk
G.W. Wolthuis	
C. Kruyskamp	Rotterdam
G. Jo Steenbergen	
A.H. Kooyker	
Hendricus Sparnaay	Rotterdam
A.G.J. Hermans	Nevele
A.M.J. van Spaendonck	
Reind J. Elema	
P.A.F. van Veen	Den Haag
M.A.F. Ostendorf	
J.W.F.X. de Rijk	
J.H. van Waveren	
D. Holzscherer	
Johannes Steenmeijer	Amsterdam
Hugo Willem Bosscha	
A.E. Meeussen	
B.C. Damsteegt	Rotterdam
A.H. Kan	
J.G. Dijkstra	
Marten Jan van der Meer	
A. van Loey	Elsene
M.A. Nauwelaerts	
Jan Poortman	De Wijk
W.J. Buma	Den Haag
N. de Bresser	
J.H. Kramer	
L.G. Oosten-Marwitz	
A.P. Braakhuis	
Lambartus Stoppendaal Pieters zoon	Nijmegen
G.W. Jansen	
A.G. van der Horst	
J.C. van Holten	
G.Th.M. Verhaak	
S.P. Uri	Delft
H. Vogelsang	
F.H. Jansen	
Aletta Huijsinga	
J. de Kruys	
A.A.M. de Villiers	
F.I.J. van Rensburg	
G. Colmjon	Leeuwarden
M.J. van Westenbrugge	
C. Kostelijk	
J.B. Drewes	Amsterdam
F.J.P. Peeters	
B.W.E. Veurman	
A.P. de Bont	
M. Zwaagdijk	
Hubert J. Michaël	Den Haag
C.M. Geerars	Eemnes
A.G.F. van Holk	Utrecht
F. van Vinckenroye	Kortessem
Jan Frans Gratiaen	Brugge
Bert Japin	Rotterdam
A.I.M. van der Waag	
A.P. Cornet	
A.F. Manning	
Q.W.J. Daas	
W. van Beusekom	
J. Vergote	Gent
John de Pool	
R. Haeseryn	Massemen
Arnold J.T. Stakenburg	
M.A. Kerckhove	
C.J.H. Steketee	
A.W.P. van Ree	
B.M. Salman	
H. Roose	
W.H. Vroom	
D.B. van Nisius	
L. Peeters	Heppen
J.C. Arens	Hengelo
J.A. Verhage	
Theo Vindevogel	
A.G. van Melle	
Jan van Elsland	Haarlem?
J.A. Huisman	Wijk bij Duurstede
J. Kwekkeboom	
A.W. Krijgsman	
Jan C. Villerius	
H. Weigert	Bavaria
W. Gobbers	Antwerpen
Jaap Meijer	Winschoten
J. van der Steen	
B. de Ligt	
Peter van Eeten	
Marie van Kranendonk	Delft
J. Leenen	Opgrimbie
Johannes van der Schaar	Vlaardingen
B.A. Mensink	
Willem Sluiter	Neede
J.M.H. Vossen	Heverlee
Theo Oudkerk Pool	
J.F. Couwenbergh	
C. Bruins	
B. Ouwerkerk	
B.G.L. Overmaat	Enschede
P.J. Vinken	Treebeek
Raymond Kaye	
P.J. Merckens	
J. Berits	Rotterdam
Gerhard Worgt	
T.J.M. Versteeg	
Marcel Hoebeke	
Jelle van der Meulen	
J.L. Price	
H.Th. Kok	
A. Mankes-Zernike	Amsterdam
R. Vos	
Tibor Klaniczay	
H. Schönbeck	
G.C. de Waard	
Paul Delsemme	Brussel
R. Galderoux	
F.K.M. Mars	
Jules de Corte	Deurne
P.E.L. Verkuyl	
J. Hollestelle	Breda
J. de Ligne van Arenberg	
F.M. Gelens	
H.M. Hermkens	
A.J. Verschoor	
I.D. du Plessis	Kaapstad
Frank van Gestel	
Norbert Morciniec	
P. Gerbenzon	Leeuwarden
Gerhard Kuipers	
Nienke Bakker	Amsterdam
Hanneke van Buuren	Breda
H.J.J. Piket	
Albert van Hogenbemt	
S.C. Holleman-Stevens	
C. van de Ketterij	
E.F. Wijsman	
A. Roels	
Jakob Zeeus	Zevenbergen
A. Jacob-Bekaert	
Dora van Velden	
E. Nuijtens	
Justus de Harduwijn	Gent
Jacobus Revius	Deventer
N.J. Schuurmans	
Michael van de heilige Augustinus	
Henk Hollaar	
Jaap de Rooij	Amsterdam
S.A.E. van Puffelen	
F. Revet	
S.A.P.J.H. Iansen	Schiedam
Wilco H. thoe Schwartzenberg en Hohenlansberg	Anjum
B.W. Schippers	
Claas W. de Kruyter	Alblasserdam
H. van 't Veld	
W.M.H. Hummelen	Zutphen
C. van Duijn jr.	
H.B. de Groot	
W. Martin	
Abraham Maas	
Ferdinand van Ingen	Utrecht
Berend Jager	Coevorden
Willem M. Visser	
Jacques Zajicek	
Adrianus van Selms	Amsterdam
R.C. Engelberts	
Jacques Voisine	
A.M.C. van Schaik-Verlee	
H. Prudon	
Yvette Stoops	
G.H. Dijkstra	
R.P. Botha	Kaapstad
P.E.M. Boer	
J. 't Hart	
Epictetus	Turkije
F.J. Koopmans-Van Beinum	
J.P. Willems	
G.J. Helmer	
Paul C.H. van der Goor	Gebroek
G.C. Lijphart-Bezuidenhout	
Wim Hendriks	Montfoort
P.J.F.M. Eligh	Breda
Piet Delen	
Hans van Dijk	Deventer
Albert Schaalma	
W.H. Morel-van Mourik	
M.E. van Slooten	
J.B. de Caluwé	
C. Monster	
G.A. van Es	Leeuwarden
A.J. Welschen	
J. IJsewijn	
G.M. Mesland	
E. Cramer-Peeters	
J.J.M. Westenbroek	Den Haag
Fr. Daems	
Maurits Gysseling	
B. Rademaker-Helfferich	
Arnold Evers	
M.J.M. de Haan	
Harry Scholten	Voorschoten
Pim de Vroomen	
R. Hamburger	
J.M.F. Stalpers	
Bert Hofman	
René Jongen	
Fons van Buuren	
H.H. Grünhagen	
T. Hagtingius	
H.M. Eliassen-de Kat	Rotterdam
R. Eeckhout	Bredene
Jacobus Koelman	Utrecht
A.W. ter Horst	
Gysbert Koelstra	
C.M. Verkroost	
Coen Bersma	
Anton Roothaert	Tilburg
G. Scherps	
J.A. van Leuvensteijn	Alkmaar
P.K. Niekerk	
Eep Francken	
J. Taeldeman	Kleit
Piet Kralt	Leiden
W.J.M. van Calcar	
Bert van Selm	Delft
G.J.P. van Hoek	
W.A. Wijnands	
K.R. de Graaf	Den Helder
Herman Wekker	
Jan Gijsel	
Ph. van de Nieuwegiessen	
Dick Springorum	
A.A. Keersmaekers	Retie
G. De Schutter	Ekeren-Hoogboom
P. van der Woude	
J.F. Geerds	
Evert de Jong	
Nigel F. Palmer	Groot-Brittannië (en Noord-Ierland)
P. Lammens-Pikhaus	
Wil Sterenborg	Lichtenvoorde
J.A. Verschoor	
Reinhilde Haest	
D.H. Lammers	
M.F. Steehouder	
Leonard Forster	Londen
Petrus de Jong	
P. van Overbeeke	
Edward Al. Th. Stam	
Seymour L. Flaxman	
P.W.J.L. Gerretsen	Utrecht
Domien ten Berge	
Jac. de la Torre	Den Haag
D. Gil-Günzburger	
S.A.J. van Faassen	Assen
C.S.M. Rademaker	
Leo van Maris	
Th.H. van Doorn	
Bert van den Broeck	
Frederik Jacobus Brevet	Den Haag
H.J. de Roy van Zuydewijn	Amsterdam
Ton Goeman	
J. de Gier	Maartensdijk
H.J.A. Bolscher	
N.C. van Velzen	
C. Gussenhoven	
Evert van den Berg	
Alfred M.M. Dekker	
R. Blok	
H.W.J. Vekeman	Grimminge
Dirk Coigneau	
Hans den Haan	
A.A. Monden	
Willemien B. de Vries	Alkmaar
H.Chr. van Bemmel	
Johan van der Auwera	
G.A. Bredero	
Guido de Baere	
R. Jansen-Sieben	
Elie Nieuwborg	
C. Rooker	
Odo Leys	
Jos A.A.M. Biemans	
A.H. Touber	
Henry Hargreaves	
J.C. van Aart	
J.C. Trimp	
Stanislaw Predota	
A.G.M. Vermeulen	
Hanna Stouten	
J.C. Prins s'Jacob	
J. Kreuzen	
Henk Meter	
Hubert Meeus	
Oskar Wellens	
Roger Gilis	
E.W.F. van den Elzen	Helmond
F.R. Gilfillan	Warmbad, Transvaal
W.A.A.M. Merlijn	
J.W. Steenbeek	Dorkwerd
L.E. Wirth-van Wijk	
Gerard Verhoeven	
Jos Houtsma	
Henk Koeman	
R.W.W.M. van der Drift	
J.H. Winkelman	Rotterdam
Tom Hage	
Ton Vallen	
Joke van der Wiel	
C.J.M. Jansen	
Annemarie Kets	
Dirk Geirnaert	
L. Boves	
F.J. Lodder	
Robert Hennebo	Leiden
Gerrit van Olivier	Dordrecht
J. A. Le Loux-Schuringa	
P.N.G. Pesch	
Jos Versteegen	Panningen
Robert Jan van der Drift	
Jacobus Jansonius	
Didier L. Goyvaerts	
Aafje Gijsen	
Marlies Philippa	
Lucie Huiskens	
Jan Nuyts	
Bart Besamusca	
Irene Spijker	
P. van Hees	
G.P. van der Stroom	
Egon Berendsen	
T.M. Verhage-van den Berg	
Astrid Joosse	
Jan Siemons	
Gerben Wynia	
Eveline Buchheim	
Johan Verhoeven	
Marjan Birkenhäger	
Baukje van Dam-Heringa	
Hans Heinrich Meier	Zwitserland
F.J.A. Jagtenberg	
Thijs Pollmann	Amsterdam
Jip Wester	
Roger Henrard	Ans, bij Luik
G.J. Vroeijenstijn	
Wilbert Spooren	
Gunilla Dalberg	
G. Gerritsen-Geywitz	
Renaat J.G.A.A. Gaspar	Sint Katelijne Waver
W.C.E. Koksma-ten Cate	
Sytske Sötemann	
Pieter Nieuwint	
Ans van Kemenade	
J.H. Reitz	
J.H. de Ridder	
Marysa Demoor	
Eberhard Nehlsen	
Maaike Hogenhout-Mulder	
Tini Booij	
F.A.M. Riem Vis	
Anja van Leusden	
Fieny Pijls	
Frank van den Dungen	
Wilbert Smulders	
Jan Nijen Twilhaar	
G. van Eemeren	
Rik Smits	
C. van Coll	
F. Stuurman	
Dieuwke E. van der Poel	
W.F.G. Breekveldt	
J.P. Westgeest	
T.H.J. Broekmans	
A.H.M. de Graaf	
Els den Os	
Paulien Smabers	
Tineke ter Meer	
J.Ph. van Oostrom	
Annejoke Smids	Minnertsga
Elly van Gelderen	
Jeanette Koekman	
G.C. de Vries	Delft
A.E. Jacobs	
C.J. van Veen	
Lia van Gemert	
Meinardus Siderius Wal	Leeuwarden
P.P. Schmidt	
M. Everaert	
Clara Strijbosch	
Mieke B. Smits-Veldt	
Ad Leerintveld	
T.-M. Nischik	
Rudi Hendrickx	
Olf Praamstra	
Jacqueline Frijn	
Wim de Haas	
Theodoor Rodenburg	Antwerpen?
Jan Konst	
Jan Don	
Marijke Spies	Eindhoven
Johan Th. Veenhof	
István Bejczy	
P.R.F. Verhoeven	
Jan Willem Klein	
M.G.M. Elling	
Frank van Lamoen	
Marcel Bax	
Geert Warnar	Oegstgeest
H.W.A. Nap	
Gert-Jan Johannes	
Theo Meder	
Jan Oegema	
Freddy Puts	
Wolfgang Herrlitz	
Mieke van Dalen	
Leo Jansen	
Jacqueline Hulst	
Orlanda S.H. Lie	
Elisabeth Paling Funk	
Eric Hoekstra	
Louis Herreboudt	Brugge
Ton van der Wouden	Gouda
H. Bonset	
Jan Kuys	
Freddy van Besien	Gent
Josien Brink-Hendriks	
Luuk Lagerwerf	
Jacqueline de Man	
Michiel Leezenberg	
Marjolein Hogenbirk	
Thom Mertens	
Petra Hendriks	
Renée van Bezooijen	
Goudina van Weert	
Bernadette Smelik	
Annelies van Gijsen	
Erwin Mantingh	
Elisabeth Kappner	
Louis Peter Grijp	Den Haag
René van Stipriaan	Heerhugowaard
Olga van Marion	Schiedam
Enny de Bruijn	
Emmeken van der Heijden	
Ben Peperkamp	Den Haag
Erica van Boven	Breda
Louis Cornelis	
P.J.A. Franssen	
Andrzej Dabrówka	
W.R.D. van Oostrum	
V.E. de Gruiter	Semarang
Bertram Mourits	
Nelleke Moser	
Ruth Beijert	
H.F. van de Velde	
Hans Broekhuis	
Dorthe Schipperheijn	
Bernard Shaw	Dublin
J. Haesaert	
Marcel Poot	Vilvoorde
Gerard van Elden	
Eugenie Boeye	Antwerpen
Karl Renner	Unter-Tannowitz
Tonny van der Horst	Rotterdam
C. Heymans	Gent
Jos Coveliers	
Frank de Langhe	
Richard Declerck	Brugge
J.F. Willems	Boechout
Julien de Valckenaere	Gent
Guillaume Apollinaire	Rome
D.J. Opperman	
Frank Gerdels	
Frans Smekens	Aalst
Louis Paul Boon	Aalst
Frank Craeybeckx	Antwerpen
Piet Heus	
R. Miry	
Joris Blondiau	
Hugo Walschap	
Eva Vlame	
Herwig Hensen	Antwerpen
Josee van Dirickx	
Hendrik Brehmen	
Josephus Hendrikus Cornelis Creyghton	
M. Kapteyn	
N.P. van Wyk Louw	Sutherland
Lucien Brulez	Blankenberge
Jan Bosquet	
Valère Coopmans	Hoepertingen
Pliet van Lishout	Gent
Stéphane Mallarmé	Parijs
Marc Moonen	
Erik Thys	
Clare Lennart	Hattem
Julius Valckenaere	Handzame
Constance Teichmann	Antwerpen
Jozef Cantré	Gent
Jan Verley	
Rogier Marijnissen	Gent
Hugo Brutin	Geluwe
Fjodor Sologoeb	
Ankie Peypers	Amsterdam
V.I. Lenin	Oeljanovsk
P.M. van der Vrecken	Maastricht
Jef Geeraerts	Antwerpen
[tijdschrift] Nieuw Vlaams Tijdschrift	
Jean-Marie Maes	
Tymen Trolsky	Oerle
Raymond Vervliet	
Rob Bartels	
Johannes de Bruyn	Amsterdam
Serge Govaert	
Gertrude Stein	
Michel Leclerc	
Luc Pierre Maes	Ieper
Philippe Cailliau	Elisabethstad
J. Uyttendaele	Grembergen
Marc Bruynseraede	
Stephen Crane	
Jaak van Schoor	Gent
Hubert	
Jan Vanriet	Antwerpen
Wim de Poorter	
Jana Beranová	Plzeñ
Eleonore Vigenon	
André Lefevere	
Daniël van Hecke	Gent
Konstantínos Kaváfis	
Eric Rinckhout	
Gérard de Nerval	Parijs
Franc Schuerewegen	
Eriek Verpale	Zelzate
Hugo von Hofmannsthal	
Hans Turken	
Lidy van Eijsselsteijn	Nieuwe Pekela
Anna Mertens	
Anna de Noailles	
Andries Dongera	
Dieuw Schepel	Oosternijkerk
J.A. Risseeuw	
Inge Lievaart	Oosterend
D.I. Bouman-Eringa	
M. 't Hooft	
Jacoba M. Vreugdenhil	
Arjen Miedema	
Jan Elzo Niemeijer	
P. Eringa	
Hans Barendregt	Amsterdam
[tijdschrift] Ontmoeting	
H. Mulder	
Neels Everards	
Jo van Dorp-Ypma	Haastrecht
Jan Dolfering	
Peter v.d. Braken	
Wilma	Zetten
Anthonie Stolk	Rotterdam
L.H. Stronkhorst	
Jaap Das	
W.G. Scheeres	
Johan West	
C.J. Nobel	
Gerda Meylink	
Jo Kalmijn-Spierenburg	Utrecht
H.J. van Boekhoven	
Henk Krijger	
H.H. Wilmink	
Gera Kraan-van den Burg	
Rie Bauer	
G.E. Woneman	
Willem M. Kruseman	
P.B. van Dalfsen	
M.A. Rijnsburger	
Gerrit Mulder	
Margreeth Woltjes	
Mischa S. van den Bosch	
Frans Leonard	
Jan D. Stipes	
P.A. Hekstra	
A. Wapenaar	Vlaardingen
S.P. Akkerman	
A. Middelhoek	
A.H. Peters	
J. Veerman	
Else Wichers	
Diet Kramer	Amsterdam
Aart Romijn	Zaandam
Walter Raleigh	
Jac. Kort	
Niek van der Heide	
J.W. Bonda	
Feitse Boerwinkel	Amersfoort
D. Hendrikse	
Tjalling	
C. Ouboter	
K.J. Popma	
Arthur Hugh Clough	
Louise Imogen Guiney	
Huib A.P. Eijkelenboom	
Do van der Sloot	
Ralph Degens	
J.H. van der Starre	Hertogenbosch
W. Ruiten	
Jan G. van Straaten	
Okke Jager	Delft
H. Boekenogen	
J.G. Rikkert	
G. Boogaard	
Charles Marie René Leconte de Lisle	
Franz Werfel	
H-K. Mulder	
Ab van Eijk	
A.M. Spanjer	
Willem Mudde	
Félix Lope de Vega	
P.B. Shelley	
W.J. Schulte Nordholt	
B. Nijenhuis	
Etus Alons-Bernhardt	
Endre Ady	
Aize de Visser	
J.C. Schuller	
G.E. Mulder	
Lien Fokker	
M.H. Rijnsburger	
Aad Hollebeek	
A.J. Rijnsburger	
Herman Steggerda	
Jan Das	
Arie Nelemaat	
M. Monsinga	
Nora Petit	Amsterdam
Constant Labruyère	
Jan Rijnsdorp	
Gré van der Laan	
Marinus A. den Braber	
H. Ravestein	
Gerard van Hulst	
Ev. Grolle	
G.K. van Dongen	
Jac. Lelsz	
D. Kilinow	
A. Sterveen	
Harro Storm	
J.W. Veerman	
J. Kramer-Vreugdenhil	
N. Sterveen	
Francine Schregel-Onstein	
Marius Goedhart	
Gert Overduin	
Jacques Reugebrink	
Jan Stolk	Rotterdam
Johanna de Geus	
M. Beinema	
Fred van Viet	
Ger Bendels	
Freek de Leeuw	
Dirk van der Ploeg	
F. Springer	Batavia
Henk Kooijman	Haastrecht
Stuart B. Jackman	
Adriaan Donker	Rotterdam
H. de Jongste	
Elsa Sophia von Kamphoevener	Hameln
M.C. v.d. Panne	
Daan Mondgaas	
A. Mertens	
Peter Berghe	
Fred. van Zutphen	
G. van Heerde	
Arie Vermeer	
Luitzen Visser	Achtkarspelen
Ineke Sikkema	
Jan Verhoef	
Dick Steenkamp	Batavia
Jarry Duclay	Schagen
Luc von Seller	
Ubbo-Derk Hakholt	
Jan van Biezen	Wassenaar
N.H. Ridderbos	
Durk van der Ploeg	Hoogkarspel
Nico Rigter	
Bill Kroekow	
J.G. van der Veen	
Lode Bisschop	Groningen
Frederice Kalmijn	Utrecht
Jean Brüll	
Wim Pendrecht	
L. Schultz	
Heppe de Moor	
Wim Brinkman	
Jan Sleeboom	
Eric Marloux	
Theo van Roon	
Marianne Colijn	Sumatra
G. Burger	
S.J. Popma	
P. Ruysch van Dugteren	
Elisabeth Wolters	
Hans de Boer	
Anneke Geluk	
L. de Liefde	
Jaap Zijlstra	Wassenaar
Govert A. den Hartogh	
Gert Slings	Munnekezijl
William Wordsworth	
Jan ter Horst	
Tom Naastepad	Den Haag
Johan Schooneberg	
Bert Jansma	
Rob Scherjon	Amsterdam
M.G.J. Teerink	
Anton B. Lam	
Tom Etty	
S.H. Haan	
Frans van der Linde	
Gerd Segers	
Jan C. Brouwer	
R.G.K. Kraan	Vlaardingen
Marijke Baars	
W.N. Visserman	
Murk A. J. Popma	
Cees van Dop	
Nelleke Groenewegen	
Dick Zaal	
Jan J. Abels	
Mei Hwa Tan	China
Kees Ouboter	
Jan van Royen	
John Keats	Londen
Marie-Sophie Nathusius	Amsterdam
Sifra Hugorina	
Jan Donia	
Paul Wessel	
Wim Bazuynen	
Hans Dullaart	
Eric Heidbuchel	
Hans Bouma	
Anno van Workum	
Jan Sizoo	
Frans Vanderlinde	
Maja Burghout	
Teije Brattinga	Blauwhuis
Roel van Heerde	
Jo Datema	
William Blake	Londen
William Butler Yeats	
Arnold van Dijk	
A. de Kool	
P. van Amstel	
Albert Nap	
J.F.M.J. Jansen	
D.J. Sikkens	
A.J. van Dulst	
Peter van Amstel	
Pierre de Ronsard	Couture-sur-Loir
Philippe Desportes	Chartres
Alexander West	
Frederice van Faassen	
J. Deschamps	Leuven
Bert Verm	
Emiel Willekens	
J. Noë	
Aloïs Gerlo	Baasrode
Cola Minis	
D. Geeraerts	
Karel Deleu	
Willem van Eeghem	Brugge
Lucie Roobrouck	Kortrijk
Willem de Jong	Loenen aan de Vecht
Felisberto Hérnandez	Montevideo
Johann Damiaan Degreef	Nijmegen
Maria-Augusta Jacobs	
Hugo Dyserinck	Brugge
J. Donkers	
Gilbert De Smet	Bevere
Carlos Tindemans	
Lieve Scheer	
H. Vandermoere	Brugge
Nico de Vrede	
Piet Thomas	Aalst
I. Demarre	
E. van der Heijden	Hilvarenbeek
Colijn Caillieu	
Herman Servotte	Gent
A. van Branteghem	
Prosper Arents	Borgerhout
F.H.M. Hertoghs	
W.A.F. Janssen	Venray
Koen Wauters	
P.H. King	
Jan Persyn	
G. van Gorp	Alphen
Bert Kooijman	
D. Kuijper Fzn.	
Jef Barthels	
P.S.N. Oost	
Louis Gillet	
P.Th. Elsinga	
Gust Faes	
J. Goffard	
Louis Dieltjens	
Henri Bossaert	Brugge
Hugo De Schampheleire	
F. Steyaert	
Michel Dupuis	
Jan de Piere	
Jan Schoolmeesters	
Amand Berteloot	
Joannes Smeyers	
Rolf Italiaander	Leipzig
M.S.J. Cox-Andrau	Utrecht
Lieven D' Hulst	
Paul Gillaerts	
Dorian Cumps	
Luc Libaut	
Paul Schampaert	
Ingrid van de Wijer	
J. Huyghebaert	
Pascal Tasiaux	
Karel Hellemans	Borgerhout
J. Delsing	
Gisleine Peeters	
Arie Zevenhuijzen	
Viviane Geuffens	
Martha Gerlo	
N. Rowan	
Ludo Verbeeck	
Marc Van Vaeck	
Luc Dirikx	
Piet de Keyser	Knokke
Theo Coun	
Robert Vandeputte	Antwerpen
Jos. Deckers	
R. van Ooteghem	
K. du Bois de Vroylande	
R. Verschroeven	
C. de Bievre	
R. Goris	
J. Hoet	
Gaston Van Bulck	
J. Verelst	
K. van Baarle	
M. Dufraing	
Ad. Jansen	
Alb. Raignier	
Alex Harlssen	
F. De Raedemaeker	
A.J. Michielsen	
Peeters	
M.F. Schurmans	Baarle-Hertog
Louis H.M. Monden	
J. De Munter	
H. Robbers	
Jan van Gorp	
J.M. Eylenbosch	
E. Verstraelen	
Fernand Van Goethem	Lokeren
J. Nolf	
H. Bruders	
L. Elaut	Gentbrugge
E.J. Vandenbussche	
W. Matthijs	
Angelo Brucculeri	
H. Thielemans	
K.M. Houtaar	
Maria Gerarda	
A. Seeldraeyers	
Alb. Block	
P. Lassalle	
J. van Heugten	Asten
August Brunner	Orschwihr
Emiel van Coppenolle	Bovekerke
W. Arts	
Hub. Gesp	
H.F. Koster	
J. Donceel	
Juliaan Vervoort	
F. Schröder	
R. Dellaert	
J.I. Corrigan	
E.A. Ryan	
A. Grootjans	
Jan Jozef van Laer	Turnhout
A. Seeldrayers	
A. Snoeck	
A. de Guchteneere	
J. Volckaert	
Yves de La Brière	
Hugo Vandeperre	
E. de Strycker	
Constantinus	
P. de Bruin	
J.B. Poukens	
L. Moereels	
W. Cracco	
Arthur Thomas	
Ludwig Drees	
H. Geerts	
L. Vander Kerken	
L. Moreels	
C. Kock	
Edouard Dhanis	
de Caigny	
L.G. Polspoel	
R. van Lennep	
J.E. Schulte	
W. De Roy	
Jozef Mertens	
J. Theyskens	
Otto Forst de Battaglia	
Philippe Joseph Aimé van Isacker	Torhout
P. Ellerbeek	
Alb. Hernould	
W. van Dingenen	
G. De Wolf	
Maurice De Tollenaere	
Michiel Dierickx	Zingem
W. Talloen	
Louis Janssens	Olen
R. Leijs	
Albert Dondeyne	Lo-Reninge
Diotimos	
J. Bogaerts	
B. Spaapen	
E. De Cooman	
M. van den Daele	
G. Neefs	
Fr. van Baarle	
Pieter Frans Fransen	
A. Taymans	
Louis Sourie	Sint-Kruis
Jozef Marechal	Brugge
Marcel Duchateau	Merksplas
L. Baudez	
A. Poncelet	
L. Vanderkerckhove	
H. Walgrave	
Emiel van der Donck	
H. Peeters	
Walter F. Smet	
J. Köhlbrugge	
J.M.L. Demeyere	
L. van der Bossche	
W. Luyten	
J. Cuypers	
Albert Kluyskens	Landegem
Karel van Isacker	Mechelen
P. Goedertier	
B. De Wint	
Antoon Fimmers	
J. De Fraine	
M.C. Arnemann	
J.B. Goetstouwers	
Nabor Devolder	Wakken
A. Verbist	
G. Van Cutsem	
A. Meeus	
D. Merlevede	Geluveld
J. Nuttin	Zwevegem
L.P. van den Bergh	
H.L. van Breda	
I. De la Potterie	
M. Mesotten	
G. Homble	
Jos Philippen	
C. Pickery	
W. de Weerdt	
Rika De Backer-Van Ocken	
J. Lebeer	
Valentinus Morel	
Gaston Eyskens	Lier
F.X. van der Straten-Waillet	
Louis Bruyns	Essen
Monique Darge	Brugge
Paul Maria Jozef de Meester	
Jacques E. Mertens	
A. de Meyer	
Jacques Tremblay	
Albert Deblaere	
L. de Borman	
J.A.F. Wils	Nijmegen
Gaston de Jaegher	
J. van Wing	
A. van den Meersschaut	
Victor Heylen	Rijkevorsel
Walter Couvreur	Antwerpen
Silvain Douven	
John Murray	Bonar Bridge, Schotland
Philippine vande Putte	
G. Gilleman	
Jérôme Parmentier	Bavikhove
Ulpianus Lopez	
A. Cauwe	
J. Declercq	Westouter
Clément Mertens	
H. van Straelen	
R. Windey	
Jozef Andriessen	Ekeren
J.G.M. Willebrands	
V. de Meyer	
R. Pulinckx	
Herman van Overbeke	Gent
Wilhelm de Vries	Saarbrücken
Raymond Jouve	
Robert Druwé	
Albert Van den Daele	Baaigem
Fl. Bertiau	
Oger H. Bourdeaud'huy	
Augustijn Lodewyckx	Booischot
Paul André	Genève
J. Boers	
M. Duerinck	
J. Masson	
Cornelis van der Vijver	Amsterdam
Pierre-Henri Simon	
G. de Vocht	
Marcel Cordemans	Lier
André Vandenbunder	
G. Boss	
G. Huyghe	
J. Beyer	
R. Caron	
André Vlerick	Kortrijk
Jan Engelman	Utrecht
Albert Helman	Paramaribo
Henk Kuitenbrouwer	Utrecht
Albert Kuyle	Utrecht
Marnix Gijsen	Antwerpen
H. Marsman	Zeist
Menno ter Braak	Eibergen
Anton van Duinkerken	Bergen op Zoom
N.A. Donkersloot	Rotterdam
Theun de Vries	Veenwouden
A. Viruly	Breda
Gerrit Achterberg	Langbroek
A.J.D. van Oosten	Delft
Chris de Graaff	Hertogenbosch
W.P.J. Pompe	Utrecht
Martinus Nijhoff	Den Haag
August van Cauwelaert	O.L. Vrouw-Lombeek
Herluf van Merlet	Arnhem
Jan Vercammen	Temse
F. Bordewijk	Amsterdam
Clara Eggink	Utrecht
W.H. Beuken	Valkenburg
Dirk Coster	Delft
Paul de Vree	Antwerpen
Johan Winkler	Haarlem
Jef Last	Den Haag
André Demedts	Sint Baafs Vijve
Albe	Mechelen
Gabriëlle Demedts	Sint Baafs Vijve
Bernard Delfgaauw	Amsterdam
Karel Meeuwesse	Heer
P.J. Veth	Dordrecht
George Willem Vreede	Tilburg
Willem Jan Knoop	Deventer
Antonie Niermeyer	Vlaardingen
Jan Heemskerk Azn.	Amsterdam
J.T. Buys	Amsterdam
P.A.S. van Limburg Brouwer	Luik
Eugen Mehler	Emmerich
Sytze Hoekstra Bzn.	Wieringen
R.T.H.P.L.A. van Boneval Faure	Groningen
Pieter Nicolaas Muller	Amsterdam
Johannes Pols	Den Haag
Albert Hendrik Arnoldus Ekker	Vollenhove
Cd. Busken Huet	Den Haag
Allard Pierson	Amsterdam
D.E.W. Wolff	Zwolle
W.N. du Rieu	Leiden
Nikolaas Gerard Pierson	Amsterdam
Hieronymus van Alphen	Samarang
Pieter Rutger Feith	Amsterdam
Tiberius Cornelius Winkler	Leeuwarden
Joan Karel Hendrik de Roo van Alderwerelt	Harderwijk
W.A. Reiger	Groningen
Simon Gorter	Warns
Jérome Alexandre Sillem	Amsterdam
H. Kern	Poerworedjo
W. Koster Gzn.	Boskoop
J.M. van Bemmelen	Almelo
Hendrik Wolfgang van der Meij	Gronau
J.N. van Hall	Amsterdam
Willem Kloos	Amsterdam
Pieter Lodewijk Muller	Koog a/d Zaan
Jacob Paulus Amersfoordt	Amsterdam
Pieter Antonie van der Lith	Utrecht
N. Donker	Amsterdam
Marie Henriëtte Koorders-Boeke	Amsterdam
Carel van Nievelt	Delfshaven
Hugo de Vries	Haarlem
Abraham Robert Arntzenius	Delft
S.J. Fockema Andreae	Leeuwarden
W.G.C. Byvanck	Amsterdam
Sybrandus Johannes Fockema Andreae	Beetsterzwaag
Cyriel Buysse	Nevele
D.C. Hesseling	Amsterdam
Frederik van Eeden	Haarlem
H.T. Colenbrander	Drachten
J.D. van der Waals	Leiden
K.C. Boxman-Winkler	Vianen
Jacobus Boelen Jhz.	Amsterdam
Johan de Meester	Harderwijk
Herman Teirlinck	Sint-Jans-Molenbeek
Jan L. Walch	Den Haag
Jan Greshoff	Nieuw Helvoet
D. van Blom	Leeuwarden
J.A.N. Knuttel	Delft
P.H. van Moerkerken jr.	Middelburg
C. van Vollenhoven	Dordrecht
Karel van de Woestijne	Gent
Johan Huizinga	Groningen
Annie Salomons	Rotterdam
M.H. van Campen	Amsterdam
Tannelie Blom	Lagos
G.P. Frets	Boskoop
Jan van Nijlen	Antwerpen
P.H. Ritter jr.	Utrecht
H.J. Kiewiet de Jonge	Groningen
P. Geyl	Dordrecht
Willem Jan Mari van Eysinga	Noordwijkerhout
Jan Romein	Rotterdam
Hendrik Cramer	Utrecht
E.J. Dijksterhuis	Tilburg
Achilles Mussche	Gent
Urbain van de Voorde	Blankenberge
J.A.A.H. de Beaufort	Leusden
Elisabeth Zernike	Amsterdam
P.J. Meertens	Middelburg
A. Gildemeester	Amsterdam
A.A. van Schelven	Haarlem
W.A.P. Smit	Heumen
Th.J.G. Locher	Waspik
Emmy van Lokhorst	Den Haag
Jan Toorop	Poerworedjo
Jac. van Ginneken	Oudenbosch
P.J. Idenburg	Hillegersberg
Raymond Brulez	Blankenberge
Dirk Wiersma	Groningen
Gerrit Kamphuis	Zwolle
Pieter Jan Bouman	Batavia
Gerlach Royen	Valkenburg
B.A. van Groningen	Twello
J.J. Gielen	Rucphen
Anton van der Boom	Haarlem
Maurits Uyldert	Amsterdam
Dirk Bartling	Haarlem
A.N. Molenaar	Waddinxveen
Gerard Walschap	Londerzeel (Sint-Jozef)
Edward Rombauts	Hever bij Mechelen
Miguel de Cervantes Saavedra	Alcal de Henares
Ferdinand Langen	Westernieland
Jan Barents	Den Haag
Anne de Vries	Assen
F.K.H. Kossmann	Den Haag
K.H. Heeroma	Hoorn op Terschelling
Marie Ramondt	Soekowono
Guus Dijkhuizen	Amsterdam
O. Noordenbos	Bozum
C.F.P. Stutterheim	Amsterdam
R.P. Cleveringa	Appingedam
H. Plessner	Wiesbaden
Hubert Lampo	Antwerpen
J.C.H. de Pater	Bleiswijk
Johan Daisne	Gent
P. Brommer	Driebergen
C.G.N. de Vooys	Gouda
B. Faddegon	Amsterdam
L.J. Rogier	Rotterdam
Ernst van Raalte	Rotterdam
I.J.M. van den Berg	Groningen
Henri A. Ett	Rotterdam
Maarten Schneider	Keulen
Hans Andreus	Amsterdam
Elisabeth Augustin	Berlijn
Bert Voeten	Breda
Hans Warren	Borssele
Pierre H. Dubois	Amsterdam
Pieter G. Buckinx	Kortessem
J.C. Brandt Corstius	Rotterdam
J.C.A. Fetter	Stadskanaal
Silvio d' Amico	Rome
Gerben Colmjon	Leeuwarden
A.L. Sötemann	Warmenhuizen
Julien Jozef Kuypers	Pepingen
Harry Mulisch	Haarlem
J.H. Huizinga	Groningen
P. Minderaa	Amsterdam
J.W. Schulte Nordholt	Zwolle
Leo Vroman	Gouda
Cornelis Rijnsdorp	Delfshaven
August Defresne	Maastricht
J. Presser	Amsterdam
Hubert van Herreweghen	Pamel-Roosdaal
Jan Willem Hofstra	Amsterdam
J.J.A. Mooij	Gramsbergen
Rob Nieuwenhuys	Semarang
James S. (Jim) Holmes	Collins, Iowa
Cees Nooteboom	Den Haag
Arie de Froe	Arnhem
S. Dresden	Amsterdam
Martien J.G. de Jong	Steenbergen
Piet Calis	Laren
J. Bernlef	Sint Pancras
Jan F. de Zanger	Schiedam
Paul de Wispelaere	Brugge
A.L. Constandse	Brouwershaven
V.W.D. Schenk	Meppel
Felipe M. Lorda Alaiz	Almacelles
W.J.C. Buitendijk	Amsterdam
W.L. Brugsma	Aerdenhout
J.M.J. Sicking	Den Haag
R.L.K. Fokkema	Alphen a/d Rijn
H.C. Rümke	Leiden
G. van Benthem van den Bergh	Den Haag
Annie Romein-Verschoor	Hatert
Frits Staal	Amsterdam
Rudi Fuchs	Eindhoven
Rudolf Geel	Amsterdam
Joke Kool-Smit	Utrecht
Rein Bloem	Amsterdam
W.F. Wertheim	Sint-Petersburg
Wim Hazeu	Delft
Jan Voorhoeve	Djombang
Geerten Meijsing	Eindhoven
Ton Anbeek	Ede
Cas Wouters	Sint-Michielsgestel
Peter Hoefnagels	Bilthoven
D.W. Fokkema	Utrecht
Bert Vanheste	Pervijze
Ilja Ehrenburg	Kiev
J. Pen	Lemmer
Herman Pleij	Hilversum
Mazisi Kunene	Durban
Rien T. Segers	Helmond
Wiel Kusters	Kerkrade
Maartje Draak	Venlo
Peter van Zonneveld	Leiden
Boudewijn Büch	Den Haag
Frans Boenders	Antwerpen
Rudolf Dekker	Amsterdam
Federico García Lorca	Fuente Vaqueros
Eva Abraham-van der Mark	Amsterdam
Huub Beurskens	Tegelen
Jaap Goedegebuure	Sint Annaland
Ethel Portnoy	Philadelphia
E. Braches	Padang
N.G. van Kampen	Leiden
Christel van Boheemen-Saaf	Arnhem
Joseph Brodsky	Sint Petersburg
August Hans den Boef	Rotterdam
Anneke Brassinga	Schaarsbergen
Stefan Hertmans	Gent
Frank Bovenkerk	Haarlem
Jan van Luxemburg	Haarlem
Kester Freriks	Jakarta
Kas Deprez	Lauwe
Stefaan van den Bremt	Aalst
Th. Weevers	Amersfoort
P.J. Buijnsters	Breda
Willem van den Berg	Rijswijk
Anil Ramdas	Paramaribo
Jos Joosten	Rotterdam
Mieke Bal	Heemstede
W.J. van den Akker	Oss
Rienk Visser	Leeuwarden
Joris Note	Borgerhout
Bart Vervaeck	Mortsel
Bai Juyi	China
Hugo Brems	Heverlee
Tonnus Oosterhoff	Leiden
Les Murray	Nabiac
Koen Peeters	Turnhout
Pol Hoste	Lokeren
Harry N.A. Priem	20ste eeuw
René Boomkens	Bussum
Hugo Bousset	Brussel
Kees Vuyk	20ste eeuw
Els Broeksma-van Capelle	20ste eeuw
M.E. Belpaire	Antwerpen
August Cuppens	Beringen
Jaak Muyldermans	Kapelle op den Bos
Jan Emiel Vliebergh	Zoutleeuw
A. Dupont	Amsterdam
Th. Heidebrand	19de eeuw
H. Bischoff	19de eeuw
Fr. Meeus	19de eeuw
A. Verheyen	19de eeuw
Alb. vander Elst	19de eeuw
Jules Persyn	Wachtbeke
Emiel de Grave	19de eeuw
J. Erembout	19de eeuw
Johannes Jörgensen	Svendborg
Joz. vanden Eynde	19de eeuw
Louisa Duykers	Antwerpen
J. Salsmans	Antwerpen
C.P.F. Lecoutere	Antwerpen
J. Sencie	19de eeuw
Lodewijk Dosfel	Dendermonde
Paul Bellefroid	Hasselt
G. van Poppel	19de eeuw
J. Kleyntjens	19de eeuw
C. de Waal	19de eeuw
Ernest Soens	19de eeuw
A. van Wassenhove	19de eeuw
Jan van Leenen	19de eeuw
Joris Eeckhout	Deinze
Jozef van Mierlo	Turnhout
Fernand Toussaint van Boelaere	Anderlecht
Joseph Bittremieux	Sijzele
M. Rutten	Lanaken
Fritz Francken	Antwerpen
Raphaël M.J. Kreemers	Sint Huibrechts Lille
J.A. Hallez	Sint-Amands-Puurs
Jozef Uytterhoeven	Aarschot
Léopold Levaux	Luik
Jörgen Bukdahl	Sundby
Franz de Backer	Aalst
Albert Westerlinck	Geel
J.F. Vanderheyden	Heverlee
Rainer Maria Rilke	Praag
A.L Bem	Tsjechië
Emiel Jan Janssen	Vlimmeren
Oscar Dambre	Vlamertinge
Lode Roose	Mechelen
R.F. Lissens	Leuven
Paul de Keyser	Gent
Miguel de Unamuno	Spanje
Willy Spillebeen	Westrozebeke
H. van Gorp	Herentals
Alstein	Wilrijk, Antwerpen
Jaak De Maere	Puivelde-Belsele
Erik Spinoy	Sint-Niklaas
Karel Porteman	Gullegem
Dirk de Geest	Oostende
Frank Willaert	Veurne
Ivo Michiels	Mortsel
Jo Tollebeek	Mechelen
Patrick Cornillie	Roeselare
Peter Ghyssaert	Wilrijk
Leen Huet	Hoogstraten
M.A. Schenkeveld-van der Dussen	Rotterdam
F.W. van Heerikhuizen	Enschede
J. Kamerbeek jr.	Rotterdam
W. Blok	Oegstgeest
M.C. van den Toorn	Rotterdam
N.C.H. Wijngaards	Leiden
P.C. Paardekooper	Zoeterwoude
F.L. Bastet	Haarlem
D.M. Bakker	Den Haag
Cor van Bree	Vlaardingen
B. Siertsema	Gramsbergen
B.Th. Tervoort	Groesbeek
W.J.M. Levelt	Amsterdam
J.G. Kooij	Amsterdam
J.W. de Vries	Amsterdam
P.F. Schmitz	Apeldoorn
E.K. Grootes	Anna Paulowna
A. Dees	Krabbendijke
Frank Jansen	Zaandam
Hannes Meinkema	Tiel
Harry Bekkering	Roosteren
M.F. Fresco	Düsseldorf
A. Sassen	Ter Apel
Hans Heestermans	Oud Vossemeer
Antoine Braet	Aardenburg
Will van Peer	Sint Lenaarts
J.J. Kloek	Den Haag
J.J. Moerman	Oostvoorne
René Appel	Hoogkarspel
J.G. Kruyt	Katwijk
Jan Koopmans	Holwerd
Hein Boeken	Amsterdam
Omar Khayyam	Iran
M. Schönfeld	Groningen
C.B. van Haeringen	Werkendam
Catharina Ypes	Amsterdam
F.E.J. Malherbe	Paarl
F. Veenstra	Hardegarijp
P.J. Risseeuw	Den Haag
Willem Pée	Brugge
L. Mosheuvel	Rotterdam
A. Ampe	Woesten
H.A. Wage	Roosendaal
N. de Paepe	Ninove
F.P. van Oostrom	Utrecht
P.J. Verkruijsse	Groede
Arie-Jan Gelderblom	Oosterbeek
Jean Paul Sartre	Parijs
Peter van Steen	Amsterdam
Marten Brouwer	Leeuwarden
Jan Pluvier	Schoten
Remy C. van de Kerckhove	Mechelen
Frans De Bruyn	Boom
U Win Tin	Gyobingauk
Camille Huysmans	Bilzen
Leopold Flam	Antwerpen
Marc Andries	Duffel
L.M. van Dis	Zaamslag
B. van den Berg	Kornhorn
Dirk Bax	Hoofddorp
C.N. Dubelaar	Amsterdam
W.E. Hegman	Menen
R. Lievens	Ninove
L. Koelmans	Enkhuizen
F.L. Zwaan	Jokyakarta
W.P. Gerritsen	Utrecht
Lieven Rens	Roeselare
A.N. Paasman	Hoogeveen
G.R.W. Dibbets	Nijmegen
K. Roelandts	Boom
G.J. Dorleijn	Amersfoort
Isaac Dorislaus	Alkmaar
N. van der Blom	Gorinchem
Roland Willemyns	Gent
W. Waterschoot	Grembergen
E. Oey-de Vita	Haarlem
J. Reynaert	Roeselare
Fabian R.W. Stolk	Zeist
Jan de Roder	Arnhem
Ton van Strien	Vijfhuizen
Dingeman van der Stoep	Berkel en Rodenrijs
Pieter Korthuys	Rotterdam
Johan van Hulzen	Zeist
J. van Doorne	Delft
John Donne	Londen
Frank Daen	Rotterdam
Jan D. 't Lam	Rotterdam
Jozef D. Janssens	Rijkevorsel
L. Arts	Antwerpen
J.A. van Houtte	Brugge
